Player,Elo,Games,Wins,Loss,%,Attended,Tournaments
rzr|xian,1881,84,66,18,78,12,Final Round;Hypespotting;Stunfest;South East Asia Major;EVO;CPTA Shanghai;KO Fighting Game Festival;Ultra Hyakkishu Cup;Milan Games Week;Canada Cup;CPTA Finals;Dreamhack Winter
r/kappa|infilitration,1880,92,74,18,80,13,Cannes Winter Clash;Nine States;Final Round;NorCal Regionals;CPTA KR;Texas Showdown;Stunfest;South East Asia Major;CEO;EVO;HK;First Attack;Tokyo Game Show
md|luffy,1880,78,65,13,83,11,Cannes Winter Clash;Hypespotting;Stunfest;FFM-Rumble;Dreamhack Summer;EVO;VS Fighting;EGX;Red Fight District;Milan Games Week;Dreamhack Winter
eg|momochi,1870,70,53,17,75,9,Final Round;NorCal Regionals;Stunfest;South East Asia Major;CEO;EVO;SCR;Ultra Hyakkishu Cup;Canada Cup
mcz|daigo,1867,45,34,11,75,7,Final Round;NorCal Regionals;Stunfest;South East Asia Major;CEO;EVO;Tokyo Game Show
be|nemo,1854,45,34,11,75,5,KSB 2015;EVO;Tokyo Game Show;Ultra Hyakkishu Cup;CPTA Finals
avm|gamerbee,1851,62,45,17,72,9,Final Round;NorCal Regionals;Stunfest;Dreamhack Summer;South East Asia Major;CEO;EVO;Tokyo Game Show;Canada Cup
r/kappa|zv|kazunoko,1849,76,57,19,75,11,Final Round;NorCal Regionals;CPTA KR;KSB 2015;Stunfest;South East Asia Major;CEO;EVO;Tokyo Game Show;SCR;Canada Cup
rb|bonchan,1845,103,73,30,70,15,Final Round;NorCal Regionals;CPTA KR;KSB 2015;Stunfest;FFM-Rumble;South East Asia Major;CEO;EVO;FV Cup;Tokyo Game Show;SCR;Ultra Hyakkishu Cup;Canada Cup;CPTA Finals
r/kappa|poongko,1845,70,52,18,74,11,Cannes Winter Clash;Nine States;NorCal Regionals;CPTA KR;Stunfest;FFM-Rumble;South East Asia Major;EVO;Tokyo Game Show;Ultra Hyakkishu Cup;CPTA Finals
rzr|fuudo,1830,96,67,29,69,15,Final Round;NorCal Regionals;CPTA KR;Stunfest;South East Asia Major;CEO;EVO;CPTA Shanghai;Tokyo Game Show;KO Fighting Game Festival;Ze Fighting Game Champion;SCR;Ultra Hyakkishu Cup;Milan Games Week;Canada Cup
rb|snake eyez,1826,104,76,28,73,13,Final Round;NorCal Regionals;Texas Showdown;CEO;EVO;CPTA Shanghai;Summer Jam;First Attack;TFC;Tokyo Game Show;SCR;Defend the North;Canada Cup
mcz|tokido,1818,72,49,23,68,12,Final Round;Hypespotting;CPTA KR;KSB 2015;Stunfest;FFM-Rumble;South East Asia Major;CEO;EVO;CPTA Shanghai;Tokyo Game Show;Canada Cup
qanba douyu|xiaohai,1803,78,54,24,69,11,Cannes Winter Clash;Final Round;South East Asia Major;CEO;EVO;CPTA Shanghai;HK;Saigon Cup;Ze Fighting Game Champion;SCR;CPTA Finals
gl|rb|valmaster,1791,37,24,13,64,7,Cannes Winter Clash;Stunfest;FFM-Rumble;EVO;EGX;Red Fight District;Milan Games Week
mcz|mago,1791,48,34,14,70,9,Final Round;Hypespotting;Stunfest;South East Asia Major;CEO;EVO;Tokyo Game Show;SCR;Canada Cup
eg|justin wong,1786,58,40,18,68,11,Final Round;NorCal Regionals;Northwest Majors;Texas Showdown;Combo Breaker;CEO;EVO;TFC;SCR;Defend the North;Canada Cup
inco,1786,30,22,8,73,6,Nine States;KSB 2015;EVO;Taiwan;Tokyo Game Show;Ultra Hyakkishu Cup
tsc|yomi|dieminion,1785,54,37,17,68,9,Cannes Winter Clash;Final Round;CEO;EVO;Summer Jam;TFC;SCR;Defend the North;Canada Cup
liquid|nuckledu,1780,73,51,22,69,11,Final Round;NorCal Regionals;Texas Showdown;Combo Breaker;CEO;EVO;Summer Jam;First Attack;TFC;SCR;Defend the North
kig|problem x,1778,74,54,20,72,10,Cannes Winter Clash;Hypespotting;Dreamhack Summer;VS Fighting;Summer Jam;EGX;Call of Ragnarok;Red Fight District;Defend the North;Dreamhack Winter
eg|ricki ortiz,1777,61,40,21,65,10,Final Round;NorCal Regionals;Northwest Majors;Texas Showdown;Combo Breaker;CEO;EVO;Summer Jam;TFC;Canada Cup
rzr|itabashi zangief,1772,88,60,28,68,15,Nine States;Final Round;CPTA KR;KSB 2015;South East Asia Major;EVO;FV Cup;Taiwan;Manila Cup;Saigon Cup;Tokyo Game Show;KO Fighting Game Festival;Ze Fighting Game Champion;True Challengers Costa Rica;Canada Cup
reversal|chuchu,1771,4,2,2,50,1,CPT Brazil
wfx|801 strider,1770,71,50,21,70,10,NorCal Regionals;Texas Showdown;CEO;EVO;Summer Jam;First Attack;TFC;SCR;True Challengers Costa Rica;Canada Cup
fa|ryan hart,1767,74,51,23,68,11,Cannes Winter Clash;Hypespotting;Stunfest;Dreamhack Summer;EVO;KO Fighting Game Festival;EGX;Red Fight District;Milan Games Week;Canada Cup;Dreamhack Winter
fgcbr|keoma,1766,13,11,2,84,2,CPT Brazil;Dreamhack Winter
r/kappa|misse,1763,59,40,19,67,10,Nine States;KSB 2015;South East Asia Major;EVO;Taiwan;HK;Tokyo Game Show;Ultra Hyakkishu Cup;Canada Cup;CPTA Finals
rzr|gackt,1762,46,34,12,73,6,South East Asia Major;EVO;FV Cup;Saigon Cup;Ze Fighting Game Champion;CPTA Last Chance Qualifier
pie|smug,1761,44,27,17,61,8,Final Round;NorCal Regionals;CEO;EVO;Summer Jam;TFC;Defend the North;Canada Cup
fgc|ex pugera,1761,31,23,8,74,4,NorCal Regionals;CEO;First Attack;Ultra Hyakkishu Cup
ybk|dashio,1753,21,15,6,71,3,Tokyo Game Show;KO Fighting Game Festival;Ultra Hyakkishu Cup
ccg|humanbomb,1753,75,51,24,68,12,Abuget Cup;CPTA KR;South East Asia Major;CPTA Shanghai;FV Cup;Taiwan;HK;Manila Cup;Saigon Cup;Tokyo Game Show;Ze Fighting Game Champion;Dreamhack Winter
eg|pr balrog,1750,64,40,24,62,10,Final Round;NorCal Regionals;Northwest Majors;CEO;EVO;Tokyo Game Show;SCR;True Challengers Costa Rica;Canada Cup;CPTA Last Chance Qualifier
latif,1747,11,8,3,72,2,EVO;KO Fighting Game Festival
bx3|phenom,1745,59,41,18,69,9,Cannes Winter Clash;Dreamhack Summer;EVO;Summer Jam;EGX;Call of Ragnarok;Red Fight District;Milan Games Week;Dreamhack Winter
kindevu,1745,33,22,11,66,6,South East Asia Major;EVO;Ultra Hyakkishu Cup;Milan Games Week;CPTA Last Chance Qualifier;CPTA Finals
mf|tonpy,1745,80,54,26,67,13,Cannes Winter Clash;KSB 2015;EVO;CPTA Shanghai;FV Cup;Taiwan;HK;Manila Cup;Saigon Cup;Tokyo Game Show;Ze Fighting Game Champion;Ultra Hyakkishu Cup;Milan Games Week
nishikin,1745,23,13,10,56,5,Nine States;KSB 2015;Manila Cup;Tokyo Game Show;Ultra Hyakkishu Cup
ts|reiketsu,1744,50,34,16,68,8,KSB 2015;EVO;Taiwan;Manila Cup;SCR;Ultra Hyakkishu Cup;Milan Games Week;Dreamhack Winter
hori|sako,1743,12,8,4,66,2,Cannes Winter Clash;EVO
botb|tampa bison,1743,28,19,9,67,6,Final Round;Texas Showdown;CEO;EVO;TFC;Canada Cup
mba|rize|ind|infexious,1742,44,30,14,68,7,Cannes Winter Clash;Hypespotting;FFM-Rumble;VS Fighting;EGX;Milan Games Week;Dreamhack Winter
eg|k-brad,1742,79,54,25,68,14,Final Round;NorCal Regionals;Texas Showdown;Combo Breaker;CEO;EVO;Summer Jam;First Attack;TFC;Tokyo Game Show;Red Fight District;SCR;Milan Games Week;Canada Cup
neogaf|r/kappa|koji kog,1740,35,23,12,65,6,Northwest Majors;KSB 2015;EVO;Taiwan;Tokyo Game Show;Ultra Hyakkishu Cup
rokkun,1738,8,6,2,75,1,Ultra Hyakkishu Cup
ccg|chris tatarian,1738,20,11,9,55,4,Final Round;NorCal Regionals;EVO;SCR
fdy|devil_reapers|dr|stormkubo,1738,30,19,11,63,6,Taiwan;Manila Cup;Tokyo Game Show;Ze Fighting Game Champion;Ultra Hyakkishu Cup;Canada Cup
filipinoman,1737,32,22,10,68,4,Final Round;NorCal Regionals;EVO;SCR
r/kappa|aiai,1733,19,13,6,68,3,EVO;Tokyo Game Show;Ultra Hyakkishu Cup
wso|andreas,1733,32,22,10,68,5,Hypespotting;FFM-Rumble;Dreamhack Summer;EGX;Red Fight District
ts|arturo sanchez,1733,38,24,14,63,7,Final Round;Northwest Majors;Combo Breaker;CEO;EVO;Defend the North;Canada Cup
mov,1728,36,20,16,55,7,EVO;HK;Tokyo Game Show;Ultra Hyakkishu Cup;Milan Games Week;Canada Cup;CPTA Finals
ph|lpn,1726,27,18,9,66,4,Final Round;NorCal Regionals;Northwest Majors;SCR
-6,1726,10,6,4,60,2,Tokyo Game Show;Ultra Hyakkishu Cup
lll|mbr,1726,37,25,12,67,6,Cannes Winter Clash;FFM-Rumble;Dreamhack Summer;EVO;Red Fight District;Dreamhack Winter
btm|hurricane,1726,21,14,7,66,3,Hypespotting;VS Fighting;EGX
rzr|rb,1725,30,20,10,66,5,South East Asia Major;FV Cup;Taiwan;HK;Milan Games Week
gagapa,1725,9,6,3,66,2,Stunfest;Red Fight District
ag|ltod|tlod|native impact,1724,22,15,7,68,3,Northwest Majors;CEO;Defend the North
f-word,1723,12,8,4,66,2,Cannes Winter Clash;VS Fighting
esr|gonzales,1721,89,58,31,65,15,CPTA KR;KSB 2015;EVO;FV Cup;Taiwan;HK;Manila Cup;Saigon Cup;EGX;Call of Ragnarok;Red Fight District;Ultra Hyakkishu Cup;Milan Games Week;Canada Cup;Dreamhack Winter
ybk|santarouman,1719,17,11,6,64,3,EVO;KO Fighting Game Festival;Ultra Hyakkishu Cup
801|ybk|jayce the ace,1718,26,17,9,65,4,Northwest Majors;EVO;SCR;Canada Cup
fgc|r/kappa|pepeday,1717,23,12,11,52,5,Nine States;KSB 2015;EVO;Tokyo Game Show;CPT Brazil
r/kappa|kitasenju dj,1717,10,6,4,60,2,Ultra Hyakkishu Cup;Canada Cup
ybk|shiro,1717,83,54,29,65,15,Nine States;Hypespotting;CPTA KR;KSB 2015;South East Asia Major;EVO;FV Cup;Taiwan;HK;Saigon Cup;Tokyo Game Show;Call of Ragnarok;Ze Fighting Game Champion;Ultra Hyakkishu Cup;Milan Games Week
ccg|air,1717,48,31,17,64,8,Final Round;NorCal Regionals;Northwest Majors;Texas Showdown;Combo Breaker;CEO;SCR;Canada Cup
qanba douyu|dakou,1716,46,28,18,60,8,Final Round;CEO;EVO;CPTA Shanghai;HK;Ze Fighting Game Champion;SCR;CPTA Finals
btm|tyrant,1713,40,27,13,67,5,Hypespotting;Dreamhack Summer;VS Fighting;EGX;Red Fight District
qanba douyu|dark jiewa,1713,69,46,23,66,11,Abuget Cup;CPTA KR;FFM-Rumble;EVO;CPTA Shanghai;FV Cup;Taiwan;HK;Manila Cup;Saigon Cup;Ze Fighting Game Champion
yg|yomi|joel,1713,34,22,12,64,7,Final Round;Combo Breaker;CEO;Summer Jam;TFC;SCR;Defend the North
sd|pnoy,1712,23,16,7,69,3,NorCal Regionals;EVO;SCR
um|btm|imstilldadaddy,1712,49,33,16,67,8,Cannes Winter Clash;Final Round;Hypespotting;Dreamhack Summer;VS Fighting;EGX;Red Fight District;Milan Games Week
um|btm|rmz,1711,48,31,17,64,8,Hypespotting;FFM-Rumble;Dreamhack Summer;VS Fighting;EGX;Ze Fighting Game Champion;Milan Games Week;Dreamhack Winter
dl|hamad,1709,10,6,4,60,2,CEO;EVO
corn|alucard,1707,34,23,11,67,6,Combo Breaker;CEO;EVO;Summer Jam;TFC;SCR
ph|hoodaman,1707,18,10,8,55,3,NorCal Regionals;Northwest Majors;Tokyo Game Show
rize|ind|pro fluke,1707,67,43,24,64,12,Cannes Winter Clash;Hypespotting;FFM-Rumble;Dreamhack Summer;EVO;VS Fighting;EGX;Call of Ragnarok;Red Fight District;Milan Games Week;Canada Cup;Dreamhack Winter
chuan,1706,52,34,18,65,9,Abuget Cup;CPTA KR;FV Cup;Taiwan;HK;Manila Cup;Saigon Cup;Ze Fighting Game Champion;CPTA Last Chance Qualifier
l1|zaferino,1704,14,8,6,57,3,CEO;Summer Jam;Defend the North
ta|chris g,1703,62,40,22,64,9,Final Round;NorCal Regionals;Northwest Majors;Texas Showdown;CEO;EVO;Summer Jam;First Attack;TFC
magneto1080p,1703,9,7,2,77,1,Texas Showdown
r/kappa|alex myers,1703,30,20,10,66,5,NorCal Regionals;Northwest Majors;CEO;EVO;SCR
og|shine,1701,8,4,4,50,2,Summer Jam;Defend the North
bx3|veggey,1699,17,11,6,64,3,Call of Ragnarok;Milan Games Week;Dreamhack Winter
eita,1698,35,20,15,57,8,CPTA KR;KSB 2015;Stunfest;South East Asia Major;EVO;Tokyo Game Show;Ultra Hyakkishu Cup;Milan Games Week
ph|nando tovar,1697,19,13,6,68,3,NorCal Regionals;Northwest Majors;SCR
botb|marq teddy,1697,14,8,6,57,2,NorCal Regionals;SCR
mom|eh|velociraptor,1696,27,16,11,59,6,Final Round;NorCal Regionals;CEO;EVO;Summer Jam;SCR
srkuw|botb|fawwaz,1695,16,10,6,62,3,Northwest Majors;CEO;SCR
raygo blayde|afii,1695,37,26,11,70,6,Hypespotting;FFM-Rumble;VS Fighting;EGX;Red Fight District;Milan Games Week
mor|rico suave,1695,9,6,3,66,3,Final Round;Combo Breaker;EVO
julio,1694,38,24,14,63,8,Final Round;NorCal Regionals;Northwest Majors;CEO;EVO;Summer Jam;TFC;SCR
dafeetlee,1694,17,11,6,64,4,Final Round;CEO;Defend the North;Dreamhack Winter
qanba douyu|qqel,1694,12,8,4,66,2,South East Asia Major;CPTA Shanghai
ybk|kawaguchi,1694,26,15,11,57,5,Nine States;KSB 2015;South East Asia Major;Tokyo Game Show;Ultra Hyakkishu Cup
cdv|melty|will2pac,1692,23,14,9,60,5,Cannes Winter Clash;EVO;EGX;Red Fight District;Dreamhack Winter
dl|four wude,1691,20,14,6,70,5,Final Round;Texas Showdown;CEO;EVO;SCR
jehosan,1690,6,4,2,66,1,Cannes Winter Clash
bj unchained,1688,17,10,7,58,4,Final Round;NorCal Regionals;EVO;SCR
cuongster,1687,18,10,8,55,4,Cannes Winter Clash;EGX;Red Fight District;Dreamhack Winter
bcw|brentt,1687,37,22,15,59,8,Final Round;NorCal Regionals;Northwest Majors;EVO;Summer Jam;TFC;SCR;Canada Cup
shoryusengan,1687,9,7,2,77,1,Hypespotting
wolfkrone,1686,10,7,3,70,2,Combo Breaker;EVO
ocv|12m.ocv|riceata,1686,8,5,3,62,2,Defend the North;Canada Cup
yossan,1684,7,5,2,71,1,Ultra Hyakkishu Cup
ccg|chi-rithy,1681,10,7,3,70,3,NorCal Regionals;EVO;Canada Cup
keno,1681,3,1,2,33,1,Manila Cup
hsien chang,1680,32,20,12,62,5,NorCal Regionals;Texas Showdown;CEO;EVO;SCR
iz|kaiser,1680,7,5,2,71,1,CPTA Last Chance Qualifier
gachikun,1680,13,6,7,46,4,KSB 2015;South East Asia Major;EVO;Tokyo Game Show
ybk|r,1680,11,7,4,63,2,KO Fighting Game Festival;Ultra Hyakkishu Cup
fa|big bird,1680,9,7,2,77,1,Dreamhack Winter
sml|solidjin,1679,10,7,3,70,1,VS Fighting
packz,1679,29,17,12,58,6,FFM-Rumble;VS Fighting;EGX;Call of Ragnarok;Red Fight District;Milan Games Week
akimo,1679,14,7,7,50,4,Nine States;KSB 2015;Tokyo Game Show;KO Fighting Game Festival
elchakotay,1678,9,7,2,77,1,Combo Breaker
flawless deku,1678,15,10,5,66,2,Hypespotting;EGX
wtq8|gannoon,1677,9,6,3,66,1,KO Fighting Game Festival
gxc|damascus,1675,23,16,7,69,3,Hypespotting;VS Fighting;Dreamhack Winter
r/kappa|hagejin,1673,9,6,3,66,2,Ultra Hyakkishu Cup;Canada Cup
emp|hiro,1673,7,4,3,57,2,Final Round;Defend the North
vs|rde|edinbulba,1671,12,8,4,66,2,Hypespotting;EGX
kindo,1669,18,12,6,66,3,Nine States;KSB 2015;Ultra Hyakkishu Cup
xiaolong,1669,11,7,4,63,2,Abuget Cup;CPTA Shanghai
mc|xsk samurai,1669,24,14,10,58,4,NorCal Regionals;Northwest Majors;EVO;SCR
mizoteru,1669,9,6,3,66,1,Nine States
r/kappa|ebi,1668,11,6,5,54,3,FFM-Rumble;Tokyo Game Show;Ultra Hyakkishu Cup
kok,1667,60,37,23,61,10,Nine States;CPTA KR;KSB 2015;CPTA Shanghai;FV Cup;Taiwan;HK;Saigon Cup;Ze Fighting Game Champion;CPTA Last Chance Qualifier
btm|gunslinga,1667,11,7,4,63,2,VS Fighting;EGX
choiboy,1665,6,4,2,66,1,NorCal Regionals
wtq8|nox,1664,8,5,3,62,1,KO Fighting Game Festival
ind.spb|rize|ind|ixion,1663,26,17,9,65,3,Hypespotting;Dreamhack Summer;Dreamhack Winter
30f|street11,1663,1,1,0,100,1,EVO
ybk|kichiken,1663,10,6,4,60,2,KO Fighting Game Festival;Ultra Hyakkishu Cup
commander jesse,1662,8,5,3,62,1,SCR
tsc|sanford kelly,1661,15,7,8,46,4,Final Round;CEO;EVO;Defend the North
ph|crackfiend,1660,19,11,8,57,4,NorCal Regionals;Northwest Majors;EVO;SCR
apollo steed,1660,9,6,3,66,1,Hypespotting
fgc|ooitajin,1659,2,1,1,50,1,Tokyo Game Show
cast blanka,1658,5,3,2,60,1,CEO
btm|isam,1658,11,7,4,63,2,VS Fighting;EGX
brawl|haitani,1658,35,21,14,60,7,KSB 2015;EVO;Tokyo Game Show;CPT Brazil;Ultra Hyakkishu Cup;Milan Games Week;CPTA Last Chance Qualifier
begetaminb,1657,2,1,1,50,1,EVO
sabohani,1657,7,4,3,57,3,EVO;Tokyo Game Show;Ultra Hyakkishu Cup
shimauta,1657,9,5,4,55,2,Tokyo Game Show;Ultra Hyakkishu Cup
easyman,1657,5,3,2,60,1,Milan Games Week
ninomae,1656,5,3,2,60,1,Ultra Hyakkishu Cup
gg|epic l.gg|onisan,1656,25,16,9,64,5,Final Round;Texas Showdown;Combo Breaker;CEO;EVO
db|somniac,1655,9,5,4,55,2,South East Asia Major;CPTA Last Chance Qualifier
qiuqiukof,1655,4,2,2,50,1,South East Asia Major
iperu,1654,19,11,8,57,3,NorCal Regionals;CEO;SCR
kyoku,1654,8,4,4,50,2,Tokyo Game Show;Ultra Hyakkishu Cup
german luger,1653,11,7,4,63,2,Northwest Majors;Combo Breaker
nice1,1653,11,6,5,54,2,Combo Breaker;CEO
rize|ind|boltstrike,1652,22,14,8,63,3,Hypespotting;VS Fighting;EGX
wao,1651,8,4,4,50,2,Tokyo Game Show;Ultra Hyakkishu Cup
iplay|sheva,1651,7,4,3,57,2,FFM-Rumble;Red Fight District
rize|ind|btm brian,1650,13,8,5,61,2,Hypespotting;VS Fighting
mlswear,1650,7,4,3,57,2,Texas Showdown;EVO
brick,1650,12,7,5,58,2,Dreamhack Summer;Dreamhack Winter
huanlin,1650,5,3,2,60,1,CPTA Shanghai
kenzou,1650,5,3,2,60,1,Ultra Hyakkishu Cup
epic|boi toi,1649,5,3,2,60,1,Texas Showdown
vgp|chaotix,1648,17,10,7,58,3,Northwest Majors;Texas Showdown;Canada Cup
pxg|vgp|integra,1648,15,8,7,53,4,Final Round;Texas Showdown;EVO;Defend the North
sasaki,1648,5,3,2,60,1,Ultra Hyakkishu Cup
kelvin jeon,1647,22,13,9,59,4,Final Round;NorCal Regionals;EVO;SCR
gl|saunic,1647,20,12,8,60,4,Abuget Cup;Hypespotting;FV Cup;HK
harideshi,1646,9,5,4,55,3,KSB 2015;EVO;Ultra Hyakkishu Cup
koji,1645,2,1,1,50,1,CPTA Last Chance Qualifier
demulant,1645,3,1,2,33,1,FFM-Rumble
lll|emersion,1643,14,7,7,50,4,Cannes Winter Clash;Hypespotting;FFM-Rumble;Red Fight District
laugh,1642,6,3,3,50,1,CPTA KR
uryo,1642,3,1,2,33,1,Tokyo Game Show
lingo,1642,1,0,1,0,1,Final Round
qanba douyu|god of sky,1641,25,14,11,56,5,CPTA Shanghai;Manila Cup;Saigon Cup;Ze Fighting Game Champion;CPTA Last Chance Qualifier
dbkoopa,1641,11,6,5,54,3,Nine States;CPTA KR;EVO
magnegro,1641,4,2,2,50,1,CEO
cody,1640,4,2,2,50,1,Abuget Cup
incognitus,1639,9,5,4,55,2,Hypespotting;EGX
starnab,1639,8,3,5,37,3,Cannes Winter Clash;FFM-Rumble;Red Fight District
evilyoshi,1639,6,3,3,50,1,KO Fighting Game Festival
rsd|momi,1639,1,0,1,0,1,FFM-Rumble
vivi,1638,1,0,1,0,1,EVO
m.b.,1638,1,0,1,0,1,EVO
1up|van,1638,1,0,1,0,1,Canada Cup
gg|halibel,1638,1,0,1,0,1,FFM-Rumble
qanba douyu|hurtch_vr,1636,10,6,4,60,2,CPTA Shanghai;Ze Fighting Game Champion
akainu,1636,3,1,2,33,1,Cannes Winter Clash
ttl|shinba,1636,5,2,3,40,2,EVO;Ultra Hyakkishu Cup
tkr,1635,3,1,2,33,1,Cannes Winter Clash
btm|real menace,1635,9,5,4,55,2,VS Fighting;EGX
lom|wiseblade,1633,12,7,5,58,2,Hypespotting;VS Fighting
rzr|perfect legend,1632,1,0,1,0,1,EVO
a&c|italdan,1632,4,1,3,25,2,Summer Jam;Canada Cup
lorddvd,1631,2,0,2,0,1,Cannes Winter Clash
gol|ranmasama,1631,18,10,8,55,4,Final Round;CEO;First Attack;Canada Cup
ugc|vicious,1630,16,8,8,50,3,NorCal Regionals;Northwest Majors;EVO
kyabetsu,1630,10,5,5,50,3,Nine States;Tokyo Game Show;Ultra Hyakkishu Cup
gamein,1629,4,2,2,50,1,Red Fight District
hzy,1629,5,2,3,40,2,Final Round;CPTA Last Chance Qualifier
pg|filipino champ,1629,22,12,10,54,6,Final Round;NorCal Regionals;Northwest Majors;EVO;SCR;Canada Cup
og|rlbs,1628,8,4,4,50,2,CEO;Defend the North
nayte,1628,8,4,4,50,1,Dreamhack Summer
arika,1627,18,10,8,55,4,KO Fighting Game Festival;Milan Games Week;Canada Cup;CPTA Last Chance Qualifier
ybk|kim1234,1627,38,20,18,52,7,Nine States;CPTA KR;KSB 2015;South East Asia Major;FV Cup;Taiwan;Manila Cup
manny,1623,3,1,2,33,1,Milan Games Week
gtr,1623,4,1,3,25,1,Dreamhack Winter
twiggy,1622,6,2,4,33,2,Tokyo Game Show;Ultra Hyakkishu Cup
dogura,1621,17,9,8,52,4,Northwest Majors;KSB 2015;EVO;Ultra Hyakkishu Cup
madjestik,1621,2,0,2,0,1,Cannes Winter Clash
coin up|ludovic,1618,11,4,7,36,4,Final Round;Texas Showdown;EVO;Defend the North
ag|luckyd,1617,3,0,3,0,2,EVO;Summer Jam
matsuri,1615,9,3,6,33,3,KSB 2015;Tokyo Game Show;Ultra Hyakkishu Cup
y,1614,2,0,2,0,1,Ultra Hyakkishu Cup
keijin,1614,2,0,2,0,1,Ultra Hyakkishu Cup
damdai,1613,8,3,5,37,4,Final Round;EVO;TFC;Defend the North
glb,1604,17,9,8,52,4,NorCal Regionals;Combo Breaker;CEO;SCR
fuhajin,1601,6,1,5,16,2,Cannes Winter Clash;Red Fight District
cj tajh,1591,15,11,4,73,2,Combo Breaker;CEO
vs|rize|ind|milligano,1585,13,9,4,69,2,Hypespotting;VS Fighting
isg|eightgrade,1580,8,6,2,75,1,SCR
gattikun,1580,10,7,3,70,1,Nine States
rm emp kdz,1579,15,11,4,73,2,Combo Breaker;CEO
vgp|andre west,1579,14,10,4,71,2,Combo Breaker;CEO
ettelman,1579,15,6,9,40,3,Dreamhack Summer;Red Fight District;Dreamhack Winter
srkuw you know who it is,1577,5,5,0,100,1,Northwest Majors
leslie,1575,13,9,4,69,2,FV Cup;CPTA Last Chance Qualifier
fruit,1571,7,1,6,14,2,Saigon Cup;Dreamhack Winter
gz-ben,1571,13,9,4,69,2,CPTA Shanghai;HK
アミユ,1571,12,8,4,66,1,Nine States
kreymore,1567,19,11,8,57,5,Final Round;EVO;First Attack;Defend the North;Dreamhack Winter
sfo|ghost,1567,9,7,2,77,1,VS Fighting
blockbuster jon,1567,12,8,4,66,3,NorCal Regionals;EVO;SCR
bab khangaroo,1565,8,6,2,75,1,Combo Breaker
holdy,1563,13,9,4,69,2,Combo Breaker;CEO
cublanco,1563,12,8,4,66,2,NorCal Regionals;Texas Showdown
alioune85,1563,10,7,3,70,1,Hypespotting
clim,1562,13,9,4,69,2,NorCal Regionals;Northwest Majors
ph|jame,1562,12,8,4,66,2,NorCal Regionals;Northwest Majors
koji miyake,1561,9,6,3,66,2,FV Cup;CPTA Last Chance Qualifier
white gun,1561,16,10,6,62,3,NorCal Regionals;Northwest Majors;CEO
lu|alex valle,1560,19,10,9,52,4,Texas Showdown;EVO;TFC;Canada Cup
chengfei,1559,8,6,2,75,1,CPTA Shanghai
ramen addict,1559,12,8,4,66,2,NorCal Regionals;CEO
bars sida,1558,8,6,2,75,1,CEO
ninja shalz,1558,7,5,2,71,1,EGX
许永宽 斗鱼tv/阿包,1558,6,5,1,83,1,HK
ikimashouu,1556,8,6,2,75,1,VS Fighting
soa|ibukiman,1556,6,5,1,83,1,CPT Brazil
codynp,1556,29,17,12,58,5,Hypespotting;CPTA KR;South East Asia Major;Taiwan;HK
tbr last dragon,1556,8,6,2,75,1,CEO
ind.saltykid,1556,9,6,3,66,1,Dreamhack Summer
rize|ind|sfo|omh,1556,7,5,2,71,1,Hypespotting
rida,1555,5,5,0,100,1,Texas Showdown
hamago,1555,7,5,2,71,1,Texas Showdown
chow chin pang xft_baoice,1555,6,5,1,83,1,HK
judge ashen,1555,8,6,2,75,1,CEO
hero of time,1555,8,6,2,75,1,CEO
anton,1554,11,7,4,63,2,Nine States;KSB 2015
ta psycho,1554,8,6,2,75,1,CEO
chaos time,1553,12,8,4,66,2,VS Fighting;EGX
boeken,1552,12,8,4,66,2,Northwest Majors;SCR
ip man,1552,10,7,3,70,1,Texas Showdown
berserk,1551,7,5,2,71,1,CEO
onigiri kai,1551,7,5,2,71,1,Taiwan
nacer,1551,15,9,6,60,3,NorCal Regionals;Northwest Majors;SCR
mean saltine,1550,12,8,4,66,2,Northwest Majors;Combo Breaker
evb ds ray,1549,8,5,3,62,1,First Attack
cj truth,1549,6,4,2,66,1,CEO
wtq8|dudebag,1549,6,4,2,66,1,KO Fighting Game Festival
罗晓虎,1549,6,4,2,66,1,Ze Fighting Game Champion
ultima,1547,7,5,2,71,1,NorCal Regionals
em cush,1546,7,5,2,71,1,Combo Breaker
hydebuffy,1545,6,4,2,66,2,EVO;Ultra Hyakkishu Cup
谭飞 fei,1545,7,5,2,71,1,HK
t3p|wrathmatics,1544,11,7,4,63,2,NorCal Regionals;SCR
image0/nobody,1544,8,6,2,75,1,CEO
tones (^_^),1544,8,6,2,75,1,Combo Breaker
bokkin,1544,10,6,4,60,2,Northwest Majors;SCR
brolylegs,1543,9,5,4,55,2,Texas Showdown;EVO
gambleboxer,1543,5,4,1,80,1,CPTA Last Chance Qualifier
sd|tempest,1543,10,6,4,60,2,NorCal Regionals;SCR
sfo|brylarke,1543,14,8,6,57,3,Hypespotting;VS Fighting;Milan Games Week
el cubano loco,1543,10,6,4,60,3,Northwest Majors;EVO;SCR
rockpon,1543,11,7,4,63,3,EVO;Taiwan;HK
jared,1543,7,5,2,71,1,NorCal Regionals
ace unlimited,1542,14,8,6,57,3,Final Round;CEO;TFC
espr fga mono,1542,6,4,2,66,1,CEO
valiant,1542,8,5,3,62,1,SCR
stvg|flocker,1542,11,6,5,54,3,CEO;TFC;Defend the North
prk ts|huracán azura,1541,8,5,3,62,1,First Attack
nekromantik187,1541,7,4,3,57,2,EVO;SCR
carzydog,1541,3,3,0,100,1,CPTA Last Chance Qualifier
qanba douyu|cuishao,1541,10,6,4,60,2,CPTA Shanghai;Ze Fighting Game Champion
daimon,1540,7,5,2,71,1,Taiwan
たーやん,1540,6,4,2,66,1,KSB 2015
sa cuby,1540,7,5,2,71,1,CEO
ceo|jebailey,1540,8,5,3,62,2,Combo Breaker;EVO
cocaneta,1540,6,4,2,66,1,First Attack
ninja shackz,1539,5,3,2,60,1,Cannes Winter Clash
thrillhouse,1539,7,5,2,71,1,NorCal Regionals
po yuen chan xft_nana,1539,7,5,2,71,1,HK
qanba douyu|kurenai,1539,7,5,2,71,1,CEO
stvg asiandemon,1539,6,4,2,66,1,CEO
ninja shinryu,1538,11,7,4,63,2,VS Fighting;EGX
fge olivo,1538,7,5,2,71,1,CEO
fgc|dunhill,1538,10,6,4,60,2,Nine States;Ultra Hyakkishu Cup
ab ab,1538,7,4,3,57,1,CPTA Shanghai
ckd/ds babushas,1538,7,5,2,71,1,SCR
qanba douyu|abang,1538,6,4,2,66,1,CPTA Shanghai
sa teamkhris,1538,7,5,2,71,1,CEO
wataru (japan),1538,7,5,2,71,1,Taiwan
ral,1538,7,5,2,71,1,Combo Breaker
iplay demulant,1538,6,4,2,66,1,Red Fight District
wave foomy,1538,7,5,2,71,1,TFC
redpanda knuckledust,1538,8,5,3,62,1,TFC
rde|akraat,1538,13,8,5,61,2,Hypespotting;VS Fighting
mister keebler,1538,10,6,4,60,2,CEO;SCR
mob|princess slim,1537,6,4,2,66,1,TFC
ma lung fan,1537,8,5,3,62,1,SCR
りゅうきち,1537,6,4,2,66,1,Nine States
orlando,1537,6,4,2,66,1,CEO
damurgood,1537,7,5,2,71,1,Combo Breaker
bagelobo,1537,6,4,2,66,1,CEO
のえ,1537,10,6,4,60,1,Nine States
たんげ tange,1537,6,4,2,66,1,Nine States
mx|mad,1536,5,4,1,80,1,TFC
akg shinji,1536,6,4,2,66,1,SCR
a-team pag ne glitch,1536,9,5,4,55,2,CEO;Summer Jam
ed|vsf|jinty,1536,10,6,4,60,2,Hypespotting;VS Fighting
kizzie kay,1536,10,6,4,60,2,NorCal Regionals;Northwest Majors
眉山拳王,1536,4,3,1,75,1,Ze Fighting Game Champion
stvg crespo,1536,6,4,2,66,1,CEO
bfl|zaus,1536,10,6,4,60,2,Hypespotting;VS Fighting
silg@st,1536,3,3,0,100,1,FV Cup
robbieq_108,1535,5,4,1,80,1,Hypespotting
sd|ilija,1535,6,4,2,66,1,SCR
dj_malady,1535,7,5,2,71,1,Texas Showdown
silg@shaun,1535,6,4,2,66,1,FV Cup
smbg|tangent,1534,10,6,4,60,2,NorCal Regionals;SCR
hitbox rose,1534,6,4,2,66,1,Taiwan
battousai,1534,6,4,2,66,1,FV Cup
宗慶/k,1534,6,4,2,66,1,Taiwan
pokchop,1534,11,6,5,54,3,Final Round;CEO;TFC
豪鬼王/tomy huang,1534,6,4,2,66,1,Taiwan
rodney,1534,6,4,2,66,1,CPTA Last Chance Qualifier
トモ,1534,6,4,2,66,1,Nine States
brian_f,1534,6,4,2,66,1,CEO
rize|ind|kwiddo,1534,7,4,3,57,1,Dreamhack Winter
lcx wh1sper,1534,6,4,2,66,1,CPTA Shanghai
ce jabdrunk,1533,8,5,3,62,1,NorCal Regionals
kay zhong kay(fs),1533,6,4,2,66,1,HK
qanba douyu|bei bei,1533,6,4,2,66,1,CPTA Shanghai
peejay,1533,6,4,2,66,1,NorCal Regionals
stekoh,1533,7,5,2,71,1,FV Cup
bsc nevillebamshew,1533,8,5,3,62,1,Hypespotting
bashfest,1533,17,9,8,52,3,Dreamhack Summer;Call of Ragnarok;Dreamhack Winter
cxr|@dk_brawler,1533,6,4,2,66,1,Northwest Majors
「346pro|ＹＡＳＥ」 fog_e,1533,7,5,2,71,1,Combo Breaker
shotty,1533,6,4,2,66,1,TFC
frostynuggs,1533,4,3,1,75,1,Hypespotting
xtr sd|alexis,1533,6,4,2,66,1,NorCal Regionals
eric m,1533,6,4,2,66,1,CEO
meu,1533,10,6,4,60,3,KSB 2015;Tokyo Game Show;Ultra Hyakkishu Cup
dayosha,1532,6,4,2,66,1,CEO
danny boy peru,1532,11,7,4,63,2,Combo Breaker;CEO
od|chairman,1532,7,4,3,57,1,Texas Showdown
bab ura bitchassbitch,1532,6,4,2,66,1,Combo Breaker
dickson,1532,11,6,5,54,2,Northwest Majors;CEO
tgl giefkid,1532,7,5,2,71,1,Combo Breaker
vws|j miller,1532,13,7,6,53,3,Hypespotting;VS Fighting;EGX
haizek,1532,7,4,3,57,1,First Attack
kineda,1532,6,4,2,66,1,NorCal Regionals
shbl tim,1532,6,4,2,66,1,NorCal Regionals
buttermilk chris,1532,6,4,2,66,1,CEO
royalphlush,1532,6,4,2,66,1,Combo Breaker
brillz,1532,9,5,4,55,1,Dreamhack Summer
corn sethlolol,1532,6,4,2,66,1,Combo Breaker
rig elchakotay,1532,5,3,2,60,1,Summer Jam
근성frs,1532,4,3,1,75,1,CPTA KR
chan sau cheong terry,1532,6,4,2,66,1,HK
quiquikof rank 11,1531,6,4,2,66,1,CPTA Shanghai
何琪 heqi0129,1531,6,4,2,66,1,CPTA Shanghai
yomi kush,1531,4,3,1,75,1,TFC
cla75,1531,6,4,2,66,1,Milan Games Week
deadmoo5,1531,6,4,2,66,1,Northwest Majors
afi,1531,7,4,3,57,1,Dreamhack Winter
arrow,1531,9,5,4,55,2,NorCal Regionals;SCR
rh|f4rhann,1531,6,4,2,66,1,VS Fighting
steeeeve,1531,6,4,2,66,1,NorCal Regionals
spriggan,1531,6,4,2,66,1,Combo Breaker
bcw_bushinstyle,1530,6,4,2,66,1,SCR
miamix-alex,1530,6,4,2,66,1,CEO
刘斌 sandro,1530,6,4,2,66,1,CPTA Shanghai
flaquito,1530,6,4,2,66,1,SCR
muscle steel sex appeal,1530,6,4,2,66,1,Northwest Majors
dkt,1530,10,6,4,60,2,NorCal Regionals;SCR
prk famous,1530,7,4,3,57,1,First Attack
goldman,1530,6,4,2,66,1,First Attack
starwin,1530,7,4,3,57,1,Texas Showdown
sfo|benners,1530,10,6,4,60,2,Hypespotting;VS Fighting
daniel thia,1529,6,4,2,66,1,CPTA Last Chance Qualifier
dr thomas,1529,6,4,2,66,1,Milan Games Week
lee g.y.r.o,1529,6,4,2,66,1,HK
shin87,1529,5,3,2,60,1,Milan Games Week
solrac naej,1529,6,4,2,66,1,First Attack
rockdan,1529,6,4,2,66,1,Combo Breaker
o|< (stickman),1529,6,4,2,66,1,VS Fighting
iusedoom,1529,6,4,2,66,1,CEO
corn bootlegwinner,1529,10,6,4,60,2,Combo Breaker;CEO
梁伟知 todayceo,1529,10,6,4,60,2,CPTA Shanghai;HK
winchester,1529,6,4,2,66,1,Texas Showdown
sp anbu kpb teiga,1529,6,4,2,66,1,CEO
krhs tan-tan,1529,6,4,2,66,1,CEO
fuzzy,1529,9,5,4,55,2,VS Fighting;EGX
可樂ヤン,1529,6,4,2,66,1,Taiwan
rize|ind|alaughinggoblin,1529,10,6,4,60,2,Hypespotting;VS Fighting
pun pun,1528,10,6,4,60,2,Hypespotting;VS Fighting
triiifector,1528,6,4,2,66,1,CEO
prk crank,1528,6,4,2,66,1,First Attack
botb|jester,1528,5,3,2,60,1,SCR
qanba douyu|红中大大,1528,6,4,2,66,1,CPTA Shanghai
rbl|ronaldihno,1527,6,4,2,66,1,First Attack
doomsday507,1527,8,5,3,62,2,CEO;True Challengers Costa Rica
kimlegend,1527,5,3,2,60,1,CPTA KR
rize|ind|zain,1527,9,5,4,55,2,Hypespotting;EGX
mikey r,1527,6,4,2,66,1,NorCal Regionals
daniel ta87,1526,5,3,2,60,1,Milan Games Week
sfo|zxmx,1526,6,4,2,66,1,VS Fighting
yomi da knut,1526,6,4,2,66,1,CEO
ctrl|unknown,1526,10,6,4,60,2,CEO;TFC
hunted chimera,1526,7,4,3,57,1,Texas Showdown
司超 群顿,1526,5,3,2,60,1,CPTA Shanghai
大分人,1526,9,5,4,55,2,Nine States;KSB 2015
alexarandom,1526,5,3,2,60,1,Milan Games Week
ryder,1526,5,3,2,60,1,CEO
kiyotea,1526,3,2,1,66,1,EVO
joe shyne,1526,6,4,2,66,1,CEO
corn ace king,1526,6,4,2,66,1,Combo Breaker
chinoooo,1526,7,4,3,57,1,Dreamhack Winter
ts min,1526,5,3,2,60,1,CEO
big5ive,1526,6,4,2,66,1,CEO
okkun,1525,6,3,3,50,2,EVO;Ultra Hyakkishu Cup
jojo,1525,10,5,5,50,2,CPTA Shanghai;Dreamhack Winter
ojisan,1525,5,3,2,60,1,Ultra Hyakkishu Cup
saulabis,1525,5,3,2,60,1,CPTA KR
gol|krucial b,1525,7,4,3,57,1,Texas Showdown
krash!,1525,5,3,2,60,1,NorCal Regionals
neopunisher,1525,5,3,2,60,1,Milan Games Week
tkd,1525,5,3,2,60,1,Taiwan
op|flcl,1525,5,3,2,60,1,Dreamhack Winter
wtq8|elcaptain,1525,5,3,2,60,1,KO Fighting Game Festival
viennahotdog,1525,6,4,2,66,1,SCR
solidxpanda,1525,7,4,3,57,1,Texas Showdown
chiaki,1525,8,5,3,62,1,Nine States
kwyjibo,1525,10,6,4,60,2,NorCal Regionals;CEO
gw|sketch,1525,19,9,10,47,5,CPTA KR;KSB 2015;FV Cup;Taiwan;Defend the North
ymb9|sho,1525,7,4,3,57,1,Hypespotting
futile,1524,5,3,2,60,1,SCR
clangers,1524,9,5,4,55,2,Hypespotting;VS Fighting
fno|bobbyblunts,1524,4,2,2,50,1,Defend the North
sherryjenix,1524,26,14,12,53,6,NorCal Regionals;Texas Showdown;Combo Breaker;CEO;TFC;SCR
hadoukenmd,1524,12,7,5,58,2,CEO;TFC
roman,1524,5,3,2,60,1,SCR
blazing,1524,9,5,4,55,2,CEO;First Attack
嘟嘟,1524,5,3,2,60,1,Ze Fighting Game Champion
nyanshi,1524,5,3,2,60,1,Ultra Hyakkishu Cup
schowda,1524,9,5,4,55,2,NorCal Regionals;Northwest Majors
the mechanic,1524,5,3,2,60,1,CEO
pent,1524,2,2,0,100,1,Texas Showdown
mjb,1524,6,4,2,66,1,Combo Breaker
et,1524,5,3,2,60,1,Taiwan
hunter,1524,7,4,3,57,1,KO Fighting Game Festival
天下人,1524,5,3,2,60,1,Ze Fighting Game Champion
rv_raihan,1524,5,3,2,60,1,FV Cup
bab zachary unitedstates,1524,6,4,2,66,1,Combo Breaker
海龙,1524,5,3,2,60,1,Ze Fighting Game Champion
ikari panda,1523,6,4,2,66,1,Combo Breaker
ip hoi wang xft_whip,1523,6,4,2,66,1,HK
ho wai kit cs/u2,1523,5,3,2,60,1,HK
kas_shadow,1523,6,4,2,66,1,Combo Breaker
iplay4food,1523,6,4,2,66,1,SCR
keftaroz,1523,5,3,2,60,1,Red Fight District
illoopail,1523,6,4,2,66,1,Texas Showdown
scott k wai kit,1523,5,3,2,60,1,FV Cup
srm|the white beast,1523,10,6,4,60,2,Combo Breaker;CEO
wtq8|boxer4ever,1523,5,3,2,60,1,KO Fighting Game Festival
ao omega tom hanks,1523,5,3,2,60,1,CEO
wanderlust g33k,1523,6,4,2,66,1,Combo Breaker
jet,1523,12,6,6,50,2,Dreamhack Summer;Dreamhack Winter
squall,1523,6,4,2,66,1,Combo Breaker
zakotou,1522,5,3,2,60,1,Northwest Majors
t3p valiant,1522,6,4,2,66,1,NorCal Regionals
pills,1522,6,4,2,66,1,Combo Breaker
班禅,1522,5,3,2,60,1,Ze Fighting Game Champion
ind.king funk,1522,9,4,5,44,1,Dreamhack Summer
silg@duncan,1522,5,3,2,60,1,FV Cup
pag lionheart,1522,5,3,2,60,1,CEO
bab munn3y,1522,6,4,2,66,1,Combo Breaker
ikari no k bison,1522,5,3,2,60,1,Ultra Hyakkishu Cup
相楽じあじい souraku jiaji,1522,5,3,2,60,1,Nine States
和泉康太,1522,6,4,2,66,1,Nine States
pts kool-aid,1522,6,4,2,66,1,Texas Showdown
akimoto akimo,1522,6,4,2,66,1,HK
bunsen burner,1522,5,3,2,60,1,Northwest Majors
#jarbo,1522,5,3,2,60,1,CEO
wfga higgs bison,1522,6,4,2,66,1,Combo Breaker
kbb mad titan,1522,6,4,2,66,1,CEO
jason,1522,6,4,2,66,1,VS Fighting
xero,1522,6,4,2,66,1,TFC
vgp|nashfan,1522,5,3,2,60,1,Texas Showdown
splendidnull,1522,5,3,2,60,1,Milan Games Week
nerdjosh,1522,7,4,3,57,1,TFC
tss|marsh d teach,1522,8,5,3,62,1,Texas Showdown
ohgrr,1522,6,4,2,66,1,Combo Breaker
zoro,1522,6,4,2,66,1,Taiwan
阿德,1522,6,4,2,66,1,Taiwan
bigbates,1522,6,4,2,66,1,CEO
cheungyik memory,1522,5,3,2,60,1,HK
dawgtanian,1522,9,5,4,55,2,Hypespotting;Ultra Hyakkishu Cup
蔡楚锋 528000,1522,5,3,2,60,1,HK
陳政宏 bemechen,1522,6,4,2,66,1,CPTA Shanghai
josue,1522,6,4,2,66,1,Texas Showdown
yomi|stan,1522,6,4,2,66,1,CEO
hebrew hammer,1521,6,4,2,66,1,Texas Showdown
kubo kazuo harideshi,1521,5,3,2,60,1,HK
唐医生,1521,5,3,2,60,1,Ze Fighting Game Champion
saman,1521,5,3,2,60,1,Abuget Cup
bravery,1521,5,3,2,60,1,CPTA Last Chance Qualifier
frank lotion,1521,6,4,2,66,1,CEO
anubis,1521,3,2,1,66,1,Saigon Cup
anbu exking,1521,6,4,2,66,1,CEO
hypersurge,1521,6,4,2,66,1,Texas Showdown
@speedbrkr,1521,6,4,2,66,1,Combo Breaker
deku deku tree,1521,8,4,4,50,2,EGX;Red Fight District
tamashiro,1521,5,3,2,60,1,SCR
ymb9|pappacrimson,1521,7,4,3,57,1,Hypespotting
boss don dekutree,1521,5,3,2,60,1,Hypespotting
gedub|ce|gdb|jabdrunk,1521,9,5,4,55,2,Northwest Majors;SCR
j campos,1520,5,3,2,60,1,CEO
i body him,1520,5,3,2,60,1,KO Fighting Game Festival
udlr painbot,1520,5,3,2,60,1,CEO
wtq8|aziz,1520,5,3,2,60,1,KO Fighting Game Festival
peanutryu,1520,5,3,2,60,1,FV Cup
cartoon hero,1520,5,3,2,60,1,SCR
stephen,1520,5,3,2,60,1,CEO
sa justice,1520,6,4,2,66,1,First Attack
wtq8|mrkingvega,1520,5,3,2,60,1,KO Fighting Game Festival
combo kash,1520,5,3,2,60,1,SCR
renegad,1520,4,2,2,50,1,Cannes Winter Clash
nuki,1520,1,1,0,100,1,EVO
jarbo,1520,5,3,2,60,1,First Attack
ganguro,1519,5,3,2,60,1,CPTA Last Chance Qualifier
r/sf|v.s. cjbqulix,1519,5,3,2,60,1,SCR
wa private joker,1519,5,3,2,60,1,CEO
ghos7dini,1519,5,3,2,60,1,SCR
mel,1519,5,3,2,60,1,SCR
ares016,1519,5,3,2,60,1,Taiwan
tom,1519,5,3,2,60,1,Ze Fighting Game Champion
swirlyglasses,1519,6,4,2,66,1,Texas Showdown
dirty paws,1519,5,3,2,60,1,NorCal Regionals
mookmonster,1519,5,3,2,60,1,NorCal Regionals
kaleo,1519,5,3,2,60,1,Northwest Majors
mintcheerios,1519,5,3,2,60,1,CPTA KR
axlshingo,1519,5,3,2,60,1,SCR
k/d_heyzeus775,1519,5,3,2,60,1,NorCal Regionals
bsc|shek,1519,13,7,6,53,3,Hypespotting;VS Fighting;EGX
jvdsc txk|mrh,1519,6,4,2,66,1,Texas Showdown
sfo|whoshabzthisis,1519,5,3,2,60,1,VS Fighting
duncan,1519,9,5,4,55,2,Northwest Majors;Texas Showdown
realistic,1519,5,3,2,60,1,CEO
ifd tuboware,1519,5,3,2,60,1,Combo Breaker
lom|warteacher,1519,9,5,4,55,2,VS Fighting;EGX
wtq8|meshal,1519,5,3,2,60,1,KO Fighting Game Festival
ce|cd|kumo,1519,8,4,4,50,2,NorCal Regionals;SCR
yomi|shin phoenix,1519,8,4,4,50,2,CEO;TFC
da|johnny fraudeulent,1518,5,3,2,60,1,Texas Showdown
cwalker special,1518,5,3,2,60,1,SCR
陈佳锋 幻镜/magic mirror,1518,5,3,2,60,1,CPTA Shanghai
mflo,1518,5,3,2,60,1,CPTA Last Chance Qualifier
rst richard galloway,1518,5,3,2,60,1,Hypespotting
sww|thebirdlives,1518,5,3,2,60,1,VS Fighting
li joe,1518,1,1,0,100,1,EVO
uvg|noel brown,1518,5,3,2,60,1,First Attack
louzy,1518,5,3,2,60,1,CEO
flako,1518,5,3,2,60,1,CEO
godzilla,1518,5,3,2,60,1,First Attack
minos,1518,5,3,2,60,1,Taiwan
al|servo,1518,5,3,2,60,1,Combo Breaker
wtq8|yoni,1518,5,3,2,60,1,KO Fighting Game Festival
sasa,1518,10,5,5,50,2,Taiwan;Ultra Hyakkishu Cup
kai,1518,5,3,2,60,2,EVO;Ultra Hyakkishu Cup
taboc1,1518,5,3,2,60,1,CEO
bronxpuertorock,1518,5,3,2,60,1,CEO
boochi,1517,5,3,2,60,1,KO Fighting Game Festival
歐妹/omega,1517,5,3,2,60,1,Taiwan
sfo|the pro fka pro ho,1517,5,3,2,60,1,VS Fighting
koichi,1517,4,2,2,50,1,Ultra Hyakkishu Cup
drenxan,1517,5,3,2,60,1,CEO
五股淫棍王,1517,5,3,2,60,1,Taiwan
hnh kizzie kay,1517,5,3,2,60,1,SCR
3nigmat1c,1517,5,3,2,60,1,Texas Showdown
mrannual,1517,5,3,2,60,1,CEO
何浩华 gz.roadman,1517,5,3,2,60,1,HK
cb master splinter,1517,5,3,2,60,1,Combo Breaker
dcb|afterdeath,1517,14,7,7,50,3,CEO;TFC;Defend the North
shinto~,1517,5,3,2,60,1,Ultra Hyakkishu Cup
ちゃー,1517,10,6,4,60,1,Nine States
flash metroid,1517,7,4,3,57,2,Final Round;CEO
semboosa,1517,5,3,2,60,1,KO Fighting Game Festival
iansanity,1517,1,1,0,100,1,EVO
leung philip yu fat philip leung,1517,5,3,2,60,1,HK
ajay,1517,8,4,4,50,2,Hypespotting;EGX
javits,1517,6,3,3,50,1,First Attack
will,1517,5,3,2,60,1,First Attack
atom,1517,5,3,2,60,1,Taiwan
vs|bigfool,1517,10,5,5,50,2,Hypespotting;EVO
toby lin,1517,5,3,2,60,1,Taiwan
wong ho ching river,1517,5,3,2,60,1,HK
majinshinken musa,1517,5,3,2,60,1,KO Fighting Game Festival
wong hin chung saisak,1517,5,3,2,60,1,HK
vaca89,1517,5,3,2,60,1,Milan Games Week
asc.sd alexis pinto,1516,5,3,2,60,1,SCR
そらネコ,1516,3,2,1,66,1,Nine States
raychun,1516,5,3,2,60,1,Texas Showdown
kang 康,1516,5,3,2,60,1,CPTA Shanghai
hargi,1516,5,3,2,60,1,NorCal Regionals
loyalsol,1516,5,3,2,60,1,Texas Showdown
コーヒー乳牛 coffee gyuunyuu,1516,5,3,2,60,1,Nine States
sir reginald bigglesworth,1516,5,3,2,60,1,CEO
dangief,1516,7,4,3,57,1,Hypespotting
el smith,1516,5,3,2,60,1,NorCal Regionals
weirdoneo,1516,5,3,2,60,1,CPTA KR
bsc|ultrasquaddy,1516,9,5,4,55,2,Hypespotting;EGX
armageddon,1516,5,3,2,60,1,KO Fighting Game Festival
lamerboi,1516,5,3,2,60,1,NorCal Regionals
dimmer,1516,5,3,2,60,1,Milan Games Week
黄之均 mustarday2,1516,5,3,2,60,1,CPTA Shanghai
salty kid,1516,6,3,3,50,1,Dreamhack Winter
ruben,1516,5,3,2,60,1,Milan Games Week
han fengshui,1516,4,2,2,50,1,CPTA Shanghai
[62-bit] finelikewine49,1516,5,3,2,60,1,Northwest Majors
noelbhungry,1516,5,3,2,60,1,TFC
/r/streetfighter chaos goose,1516,5,3,2,60,1,CEO
chrisdat,1516,7,4,3,57,1,Texas Showdown
twitch.tv/tuboware,1515,5,3,2,60,1,CEO
shaun,1515,6,3,3,50,1,Saigon Cup
wolf street,1515,9,5,4,55,2,NorCal Regionals;SCR
tuan mario,1515,6,3,3,50,1,Saigon Cup
wongtoutou,1515,5,3,2,60,1,CPTA Last Chance Qualifier
baotrung3108,1515,5,3,2,60,1,Saigon Cup
thereflexwonder,1515,5,3,2,60,1,CEO
chg joeystorm,1515,5,3,2,60,1,Northwest Majors
yagami,1515,13,7,6,53,2,Dreamhack Summer;Dreamhack Winter
noob_player,1515,5,3,2,60,1,KO Fighting Game Festival
tekkablade,1515,5,3,2,60,1,KO Fighting Game Festival
ryoji masaki chanson,1515,5,3,2,60,1,HK
pieguy,1515,5,3,2,60,1,NorCal Regionals
wa|dm salpacino,1515,5,3,2,60,1,NorCal Regionals
ian,1515,1,1,0,100,1,Canada Cup
dinlee,1515,5,3,2,60,1,SCR
シロマティ,1514,4,2,2,50,1,KSB 2015
张尧 haveshit,1514,5,3,2,60,1,CPTA Shanghai
iron bullet,1514,5,3,2,60,1,Hypespotting
manualcrowcaine,1514,5,3,2,60,1,CEO
finalsweek,1514,5,3,2,60,1,Texas Showdown
the best in west palm beach,1514,5,3,2,60,1,CEO
viscant,1514,14,8,6,57,3,Combo Breaker;CEO;SCR
callisto,1514,5,3,2,60,1,Combo Breaker
yomi glass sword,1514,5,3,2,60,1,Combo Breaker
cprbeastlybubble,1514,5,3,2,60,1,SCR
小靠,1514,5,3,2,60,1,Taiwan
llama,1514,5,3,2,60,1,Texas Showdown
ローキン,1514,4,2,2,50,1,KSB 2015
bobbis,1514,6,3,3,50,1,Dreamhack Winter
surruso,1514,5,3,2,60,1,SCR
phdinspd,1514,5,3,2,60,1,NorCal Regionals
vs|the janitor,1514,5,3,2,60,1,VS Fighting
butterbeefbison,1514,13,6,7,46,3,Cannes Winter Clash;Hypespotting;Red Fight District
joeycl,1514,5,3,2,60,1,Northwest Majors
東 xft_tung,1514,5,3,2,60,1,HK
duffman,1514,5,3,2,60,1,CEO
bifu|spabrog,1514,4,2,2,50,1,Defend the North
shadowchild,1514,4,2,2,50,1,First Attack
fabio zeta,1513,5,3,2,60,1,Milan Games Week
the street writer,1513,7,4,3,57,1,Hypespotting
sft|guiller br,1513,4,2,2,50,1,CPT Brazil
gankula,1513,5,3,2,60,1,CEO
be|kane blueriver,1513,17,9,8,52,4,Northwest Majors;Texas Showdown;Combo Breaker;CEO
ccg|snafoo,1513,5,2,3,40,2,EVO;Canada Cup
the time dictator,1513,9,5,4,55,2,CEO;SCR
burnside the gr8,1513,5,3,2,60,1,CEO
ig|zonvolt,1513,5,3,2,60,1,First Attack
hf|hainix,1513,9,5,4,55,2,NorCal Regionals;Northwest Majors
hcliam,1513,5,3,2,60,1,VS Fighting
myndgamez,1512,1,1,0,100,1,CEO
idgaf nytmare_raven,1512,5,3,2,60,1,Texas Showdown
dcb dark child,1512,4,2,2,50,1,Summer Jam
pahn,1512,4,2,2,50,1,Milan Games Week
twg arthur,1512,4,2,2,50,1,Texas Showdown
小康,1512,1,1,0,100,1,Taiwan
xaiah,1512,5,3,2,60,1,TFC
rize|ind|thunderbear,1512,4,2,2,50,1,Call of Ragnarok
f2g|matos,1512,1,1,0,100,1,EVO
adzi,1512,5,3,2,60,1,VS Fighting
moey,1512,1,1,0,100,1,Texas Showdown
507 doomsday,1512,1,1,0,100,1,True Challengers Costa Rica
luken,1512,1,1,0,100,1,Final Round
pepeding,1512,4,2,2,50,1,Ze Fighting Game Champion
fubarduck,1512,4,2,2,50,1,KSB 2015
roccblaze,1512,5,3,2,60,1,SCR
sherm,1512,5,3,2,60,1,CEO
mmg|abswing,1512,8,4,4,50,2,Hypespotting;VS Fighting
niine90,1512,4,2,2,50,1,Red Fight District
周怿 angle,1512,5,3,2,60,1,HK
sda fiercekyo,1512,5,3,2,60,1,CEO
dbc,1511,5,3,2,60,1,TFC
谢文斌 dudu,1511,8,4,4,50,2,CPTA Shanghai;HK
nyc yuusha,1511,5,3,2,60,1,CEO
assan chop,1511,5,3,2,60,1,Texas Showdown
iim83man,1511,4,2,2,50,1,CPTA KR
big mara ramiz,1511,4,2,2,50,1,Red Fight District
kruzee,1511,5,3,2,60,1,CEO
tanka tanky,1511,8,4,4,50,1,CPTA Last Chance Qualifier
um makai,1511,4,2,2,50,1,EGX
azteczar,1511,5,3,2,60,1,Combo Breaker
bars rida,1511,5,3,2,60,1,CEO
haber,1511,5,3,2,60,1,CEO
bcw|c3g|blaqskillz,1511,9,5,4,55,3,NorCal Regionals;EVO;SCR
lll doomdomainn,1511,4,2,2,50,1,Red Fight District
ua|brandon chun,1511,5,3,2,60,1,Texas Showdown
dm john b,1511,5,3,2,60,1,NorCal Regionals
ben-nu,1511,5,3,2,60,1,Taiwan
hogosha,1511,5,3,2,60,1,Combo Breaker
superfabiano,1511,5,3,2,60,1,Milan Games Week
smbf walkerfam,1511,4,2,2,50,1,EGX
micronukex,1511,5,3,2,60,1,CEO
iplay|yougenius,1511,7,3,4,42,2,FFM-Rumble;Red Fight District
luis,1511,5,3,2,60,1,Combo Breaker
ee eseif,1510,5,3,2,60,1,Combo Breaker
izzy,1510,5,3,2,60,1,Combo Breaker
exfinitus,1510,5,3,2,60,1,CEO
qed,1510,5,3,2,60,1,NorCal Regionals
noornabelsi,1510,5,3,2,60,1,KO Fighting Game Festival
juicyjoe,1510,4,2,2,50,1,Dreamhack Winter
王辉 dexter hui,1510,5,3,2,60,1,CPTA Shanghai
vivaldi,1510,4,2,2,50,1,CEO
cities,1510,5,3,2,60,1,Combo Breaker
heodzodzien,1510,4,2,2,50,1,Saigon Cup
chenzhou,1510,5,3,2,60,1,CPTA Shanghai
ba b_5,1510,5,3,2,60,1,Milan Games Week
the lyl3,1510,5,3,2,60,1,Milan Games Week
tong ka wing kawing,1510,5,3,2,60,1,HK
catchtheselegs,1510,5,3,2,60,1,Combo Breaker
bsida,1510,5,3,2,60,1,Texas Showdown
suktuck,1510,5,3,2,60,1,FV Cup
rikkafresh,1510,5,3,2,60,1,TFC
郑凯 znk,1510,5,3,2,60,1,CPTA Shanghai
lilsicx,1510,5,3,2,60,1,NorCal Regionals
太虎,1510,5,3,2,60,1,Ze Fighting Game Champion
cs icedarkness,1510,5,3,2,60,1,CEO
christopher lo greenboxer,1510,5,3,2,60,1,HK
mazinkaiser,1510,5,3,2,60,1,Milan Games Week
lom buffalo,1510,4,2,2,50,1,EGX
こま,1510,4,2,2,50,1,KSB 2015
yabukistyle,1510,5,3,2,60,1,Northwest Majors
bab yee kwang soo,1510,5,3,2,60,1,Combo Breaker
max ng,1510,4,2,2,50,1,FV Cup
falcomist,1510,5,3,2,60,1,NorCal Regionals
engravings,1510,5,3,2,60,1,TFC
korea player,1510,5,3,2,60,1,Nine States
ほるもん,1510,5,3,2,60,1,Nine States
gibran,1510,5,3,2,60,1,First Attack
つけめん,1510,5,3,2,60,1,Nine States
龜仙人,1510,5,3,2,60,1,Taiwan
t.j. bison,1510,5,3,2,60,1,Combo Breaker
online scrub|kaos,1510,5,3,2,60,1,Texas Showdown
倪康 duang,1510,5,3,2,60,1,CPTA Shanghai
q,1510,5,3,2,60,1,Combo Breaker
smbg|bakedmotatoes,1510,5,3,2,60,1,NorCal Regionals
giezoe,1510,5,3,2,60,1,Taiwan
ind a laughing goblin,1510,4,2,2,50,1,EGX
trevonte,1510,5,3,2,60,1,NorCal Regionals
diddy sinatra,1510,5,3,2,60,1,Combo Breaker
黄祥 been gor,1510,5,3,2,60,1,HK
goldteamrules,1510,5,3,2,60,1,CEO
kingquaka,1510,5,3,2,60,1,Hypespotting
tgz|wt kami,1510,5,3,2,60,1,SCR
tgu zhedloo,1510,3,1,2,33,1,South East Asia Major
shazy,1510,5,3,2,60,1,Hypespotting
rr|mr gork,1510,5,3,2,60,1,First Attack
cn,1510,5,3,2,60,1,Taiwan
raich,1510,5,3,2,60,1,Texas Showdown
rde|sleight,1510,5,3,2,60,1,Hypespotting
prettyminky,1510,4,2,2,50,1,CPTA KR
ed|lavell up,1510,13,7,6,53,3,Hypespotting;VS Fighting;EGX
3e.ttf|unprotectedsex,1510,4,2,2,50,1,SCR
udlr highbeast,1510,5,3,2,60,1,CEO
sww|baconjacob,1510,5,3,2,60,1,VS Fighting
gameguys naughty munkey,1509,5,3,2,60,1,Texas Showdown
sonydafa,1509,5,3,2,60,1,CPTA Shanghai
mba|dread,1509,9,5,4,55,2,Hypespotting;VS Fighting
super uriajjo,1509,4,2,2,50,1,Ultra Hyakkishu Cup
rde sefsins,1509,4,2,2,50,1,Hypespotting
wso|logan,1509,8,4,4,50,2,Hypespotting;VS Fighting
m. crash,1509,5,3,2,60,1,First Attack
better metal dingo,1509,5,3,2,60,1,CEO
rm|t-boykin,1509,5,3,2,60,1,Texas Showdown
bigvic340,1509,5,3,2,60,1,CEO
sephro8h89,1509,5,3,2,60,1,Milan Games Week
mikey g,1509,5,3,2,60,1,CEO
dn sf4killedus,1509,4,2,2,50,1,Red Fight District
fno|crazysalvi,1509,3,1,2,33,1,Defend the North
jimli,1509,8,4,4,50,2,Northwest Majors;CEO
ed|aixy,1509,5,3,2,60,1,VS Fighting
clev,1509,5,3,2,60,1,VS Fighting
anbu sonyono,1509,3,1,2,33,1,Summer Jam
hismit,1509,4,2,2,50,1,Saigon Cup
pag|sabo,1509,12,6,6,50,3,CEO;Summer Jam;First Attack
totallydrew,1509,5,3,2,60,1,CEO
lucamago,1509,4,2,2,50,1,Milan Games Week
abyss gouken respek,1509,5,3,2,60,1,CEO
smash,1509,4,2,2,50,1,Hypespotting
mr.c,1508,4,2,2,50,1,Combo Breaker
xx your disease,1508,4,2,2,50,1,Texas Showdown
noc|leviathan,1508,8,4,4,50,2,Northwest Majors;SCR
frisco,1508,4,2,2,50,1,Northwest Majors
そぼろんぐ,1508,8,4,4,50,1,Nine States
syn chuck,1508,4,2,2,50,1,EGX
glasgow kev,1508,4,2,2,50,1,Hypespotting
kaworu,1508,5,3,2,60,1,VS Fighting
fgc|sekiganryu,1508,4,2,2,50,1,Ultra Hyakkishu Cup
薛國斌 wo鵝鵝澳•餓痾澳，我比豬腰你聞,1508,4,2,2,50,1,HK
pxg wiseguy,1508,4,2,2,50,1,CEO
ponzaman,1508,7,3,4,42,2,Ultra Hyakkishu Cup;Milan Games Week
dixon,1508,2,1,1,50,1,CPTA Last Chance Qualifier
yeral,1508,4,2,2,50,1,First Attack
rs|d4rk onion,1508,4,2,2,50,1,Hypespotting
gunner85,1508,5,3,2,60,1,KO Fighting Game Festival
emerald chaos,1508,4,2,2,50,1,Hypespotting
yogadon,1507,4,2,2,50,1,NorCal Regionals
haywad,1507,4,2,2,50,1,NorCal Regionals
tg|bebedero,1507,2,1,1,50,1,True Challengers Costa Rica
rs doom,1507,4,2,2,50,1,EGX
k tousen,1507,4,2,2,50,1,Texas Showdown
g.y.r.o,1507,14,6,8,42,4,Nine States;South East Asia Major;FV Cup;Ultra Hyakkishu Cup
fancylaine,1507,4,2,2,50,1,Milan Games Week
刘锦发 chilunsin,1507,6,3,3,50,1,HK
prototype,1507,4,2,2,50,1,TFC
carlos c,1507,4,2,2,50,1,CEO
dunbine,1507,4,2,2,50,1,CPTA KR
ccg|lapchi,1507,3,1,2,33,2,EVO;Canada Cup
seinken,1507,4,2,2,50,1,CEO
scha,1507,4,2,2,50,1,Northwest Majors
rugalitarian,1507,4,2,2,50,1,CEO
soa|xr prometo,1507,4,2,2,50,1,CPT Brazil
ed|kyros,1507,11,5,6,45,3,Hypespotting;VS Fighting;EGX
dmansland,1507,9,5,4,55,2,Texas Showdown;SCR
mullen,1507,4,2,2,50,1,CPTA KR
image,1506,4,2,2,50,1,Texas Showdown
failichawy iori-q8,1506,4,2,2,50,1,KO Fighting Game Festival
vs gm punk,1506,6,3,3,50,1,Hypespotting
joyfull78,1506,4,2,2,50,1,CPTA KR
sa kooky,1506,4,2,2,50,1,CEO
nake @iran #32,1506,4,2,2,50,1,Dreamhack Winter
pg|coach steve,1506,10,4,6,40,3,Summer Jam;SCR;Defend the North
oitajin,1506,4,2,2,50,1,Ultra Hyakkishu Cup
darkhonor90,1506,4,2,2,50,1,CEO
kino,1506,4,2,2,50,1,NorCal Regionals
oppoi,1506,3,1,2,33,1,Ultra Hyakkishu Cup
smbf|yts buttface,1506,4,2,2,50,1,VS Fighting
matador kiririnshi25,1506,4,2,2,50,1,Combo Breaker
bsc|ruok,1506,8,4,4,50,2,Hypespotting;VS Fighting
jhunie,1506,4,2,2,50,1,NorCal Regionals
n1 kupo,1506,4,2,2,50,1,Northwest Majors
はげじん,1506,4,2,2,50,1,Nine States
icrossj,1506,4,2,2,50,1,SCR
danphan,1506,4,2,2,50,1,NorCal Regionals
mint310,1506,4,2,2,50,1,Ze Fighting Game Champion
lom|luckboxq,1506,9,5,4,55,2,VS Fighting;EGX
srm_leonil,1506,4,2,2,50,1,CEO
必然也,1506,4,2,2,50,1,Ze Fighting Game Champion
falling charlie,1506,4,2,2,50,1,CEO
rao,1506,4,2,2,50,1,CEO
大盗,1506,4,2,2,50,1,Ze Fighting Game Champion
devon scheer,1506,4,2,2,50,1,CEO
lutak,1506,4,2,2,50,1,Ze Fighting Game Champion
yomi cardell,1506,4,2,2,50,1,CEO
200yen,1506,4,2,2,50,1,NorCal Regionals
kaising,1506,4,2,2,50,1,SCR
anbu gasstationhobo,1506,4,2,2,50,1,CEO
txs raph,1506,4,2,2,50,1,Texas Showdown
cc armoredx,1506,4,2,2,50,1,Combo Breaker
ray,1506,4,2,2,50,1,HK
tommy gunzss,1506,6,3,3,50,1,Texas Showdown
rising superstar alfie,1506,4,2,2,50,1,EGX
willgetpaid,1506,4,2,2,50,1,NorCal Regionals
taunt,1506,3,1,2,33,1,Cannes Winter Clash
lamas,1506,4,2,2,50,1,Dreamhack Winter
billy wong billy,1506,4,2,2,50,1,HK
@deejonious,1506,4,2,2,50,1,CEO
snake belmont,1506,4,2,2,50,1,EGX
cc,1506,4,2,2,50,1,SCR
沈震宇 凶肯,1506,4,2,2,50,1,CPTA Shanghai
kurokiba,1506,4,2,2,50,1,NorCal Regionals
disabel,1506,4,2,2,50,1,NorCal Regionals
ua nori,1506,4,2,2,50,1,Texas Showdown
gs|gllty,1506,13,7,6,53,4,Final Round;Northwest Majors;Combo Breaker;CEO
bruin,1506,4,2,2,50,1,SCR
jono dori,1506,4,2,2,50,1,CEO
ce|boba tapioca,1506,4,2,2,50,1,NorCal Regionals
/r/sf|rawbertson,1505,2,1,1,50,1,Canada Cup
lenard,1505,4,2,2,50,1,CPTA Last Chance Qualifier
pauly z,1505,4,2,2,50,1,Texas Showdown
tosfhq sj,1505,4,2,2,50,1,CEO
sfo brylarke,1505,9,4,5,44,2,EGX;Dreamhack Winter
dan krolikowski,1505,4,2,2,50,1,Combo Breaker
fitri amir,1505,4,2,2,50,1,FV Cup
べにふーき,1505,4,2,2,50,1,Nine States
eta ralstaanley,1505,4,2,2,50,1,Texas Showdown
elton,1505,4,2,2,50,1,CPTA Last Chance Qualifier
templar,1505,4,2,2,50,1,Milan Games Week
starks,1505,4,2,2,50,1,CEO
xiao jj,1505,4,2,2,50,1,CPTA Shanghai
ifrit,1505,4,2,2,50,1,First Attack
iplay halibel,1505,4,2,2,50,1,Red Fight District
ymb 9 shinzou,1505,4,2,2,50,1,Hypespotting
delfonik,1505,4,2,2,50,1,CEO
leong teng fai,1505,4,2,2,50,1,FV Cup
orikasa,1505,4,2,2,50,1,Northwest Majors
hf yoga,1505,4,2,2,50,1,SCR
fv bison wong,1505,4,2,2,50,1,FV Cup
pgfx kiu,1505,4,2,2,50,1,Combo Breaker
dum yao ah,1505,4,2,2,50,1,Northwest Majors
hamu chan,1505,4,2,2,50,1,KO Fighting Game Festival
joshua alexander,1505,8,4,4,50,2,Texas Showdown;Combo Breaker
leung yau chun tomo,1505,4,2,2,50,1,HK
re: dandy cage,1505,4,2,2,50,1,Texas Showdown
d4rkn3ss aveng,1505,4,2,2,50,1,VS Fighting
kumasa,1505,4,2,2,50,1,Taiwan
redmage138,1505,4,2,2,50,1,TFC
chan king kiu cs|fa,1505,4,2,2,50,1,HK
bonkler,1505,4,2,2,50,1,Combo Breaker
sailor venus,1505,4,2,2,50,1,NorCal Regionals
shin rico suave,1505,4,2,2,50,1,CEO
flashy,1505,4,2,2,50,1,Saigon Cup
玩具,1505,4,2,2,50,1,Taiwan
sion,1505,4,2,2,50,1,Taiwan
gpl- flashkoto,1504,4,2,2,50,1,NorCal Regionals
快打傳奇lanlan,1504,4,2,2,50,1,Taiwan
g-dragon,1504,4,2,2,50,1,NorCal Regionals
strider,1504,6,3,3,50,1,Hypespotting
サエ,1504,4,2,2,50,1,Nine States
jc,1504,4,2,2,50,1,SCR
sba big arch,1504,4,2,2,50,1,NorCal Regionals
j. caesar ii,1504,4,2,2,50,1,CEO
joser,1504,4,2,2,50,1,NorCal Regionals
ssvs-allen,1504,4,2,2,50,1,Taiwan
黃勇 rc,1504,4,2,2,50,1,HK
邓志聪 dunk,1504,4,2,2,50,1,HK
rde ind gillstolemyride,1504,4,2,2,50,1,Hypespotting
spanky,1504,4,2,2,50,1,Ultra Hyakkishu Cup
dfw|saltime,1504,2,1,1,50,1,Defend the North
yoro,1504,4,2,2,50,1,Taiwan
kung sai kit xft_saiki,1504,4,2,2,50,1,HK
jinzou,1504,4,2,2,50,1,Ultra Hyakkishu Cup
polarbite,1504,4,2,2,50,1,CEO
ric104,1504,4,2,2,50,1,Combo Breaker
hideo,1504,4,2,2,50,1,Saigon Cup
謝漢傑,1504,4,2,2,50,1,Taiwan
smbf|nebbiez,1504,4,2,2,50,1,VS Fighting
droomighty,1504,4,2,2,50,1,Northwest Majors
riktigsfivspelare,1504,4,2,2,50,1,Dreamhack Winter
rde saltmine,1504,4,2,2,50,1,Hypespotting
srkuw|kpop,1504,4,2,2,50,1,Northwest Majors
volibear,1504,4,2,2,50,1,KO Fighting Game Festival
shorjewken,1504,4,2,2,50,1,Northwest Majors
kapwan,1504,4,2,2,50,1,NorCal Regionals
小武,1504,4,2,2,50,1,Taiwan
marshall king,1504,4,2,2,50,1,TFC
mr. mishida,1504,4,2,2,50,1,Texas Showdown
lushylushy,1504,4,2,2,50,1,Northwest Majors
nicktanella,1504,4,2,2,50,1,NorCal Regionals
でぇご,1504,4,2,2,50,1,Nine States
ed|the claw of god,1504,4,2,2,50,1,VS Fighting
toucan steve,1504,4,2,2,50,1,CEO
da 206 80z,1504,4,2,2,50,1,Northwest Majors
fsr wupai,1504,4,2,2,50,1,CEO
seedogpoo,1504,8,4,4,50,2,CEO;First Attack
tyram,1504,4,2,2,50,1,NorCal Regionals
david shen,1504,4,2,2,50,1,Taiwan
trainerfox,1504,4,2,2,50,1,KO Fighting Game Festival
moe,1504,4,2,2,50,1,Dreamhack Winter
阿光,1504,4,2,2,50,1,Taiwan
chg combo kin,1504,4,2,2,50,1,Northwest Majors
job gdx,1504,4,2,2,50,1,CEO
tacaño2dgod,1504,4,2,2,50,1,First Attack
ita77u,1504,4,2,2,50,1,Milan Games Week
ngi lom wiseblade,1504,4,2,2,50,1,EGX
nakahara,1504,4,2,2,50,1,Ultra Hyakkishu Cup
小嘉米 木有黑眼圈,1504,4,2,2,50,1,CPTA Shanghai
胡寅辰 justin hu,1504,4,2,2,50,1,CPTA Shanghai
finalzero,1504,4,2,2,50,1,KO Fighting Game Festival
um lemon,1504,4,2,2,50,1,EGX
da|scottfree,1504,4,2,2,50,1,Texas Showdown
dian,1504,4,2,2,50,1,Abuget Cup
faisaldante23,1504,4,2,2,50,1,Hypespotting
karmaa,1504,4,2,2,50,1,NorCal Regionals
gatk dr sloan,1504,4,2,2,50,1,Hypespotting
mulverrine,1504,4,2,2,50,1,CPTA KR
eugene yap,1504,4,2,2,50,1,FV Cup
two75,1504,4,2,2,50,1,FV Cup
dario,1504,4,2,2,50,1,Milan Games Week
sorawings,1504,4,2,2,50,1,CPTA KR
wtq8|fizzie,1504,4,2,2,50,1,KO Fighting Game Festival
harumii,1504,4,2,2,50,1,Ultra Hyakkishu Cup
shaunjs,1503,7,3,4,42,2,Hypespotting;VS Fighting
daddario,1503,4,2,2,50,1,Milan Games Week
wuming,1503,4,2,2,50,1,CPTA Last Chance Qualifier
ippolit,1503,4,2,2,50,1,Dreamhack Winter
raion,1503,4,2,2,50,1,CEO
eh nd|majintenshinhan,1503,4,2,2,50,1,Dreamhack Winter
derrick legend,1503,11,5,6,45,3,Combo Breaker;CEO;Summer Jam
sachiko,1503,4,2,2,50,1,CPTA Last Chance Qualifier
bryan papa,1503,4,2,2,50,1,NorCal Regionals
sww|rycroft,1503,4,2,2,50,1,VS Fighting
platinum kid,1503,8,4,4,50,2,VS Fighting;EGX
iki,1503,8,3,5,37,1,Dreamhack Summer
frametrap|the prince,1503,4,2,2,50,1,Dreamhack Winter
veym|noobster,1503,4,2,2,50,1,Texas Showdown
criminaldada,1503,4,2,2,50,1,Taiwan
jay jayy 90,1503,4,2,2,50,1,VS Fighting
biobillybonez,1503,8,4,4,50,2,NorCal Regionals;SCR
raykay,1503,3,1,2,33,1,KSB 2015
sean why,1503,3,1,2,33,1,TFC
bonehead,1503,4,2,2,50,1,Milan Games Week
op|sick bubblegum,1503,5,2,3,40,1,Dreamhack Winter
c-los,1503,4,2,2,50,1,NorCal Regionals
[anet]nightmare2450,1503,4,2,2,50,1,Northwest Majors
flavored,1503,4,2,2,50,1,CEO
fatso_523,1503,4,2,2,50,1,VS Fighting
tong,1503,4,2,2,50,1,Combo Breaker
naio,1503,4,2,2,50,1,Ultra Hyakkishu Cup
datc,1503,4,2,2,50,1,Northwest Majors
m a d w a k,1503,4,2,2,50,1,Combo Breaker
jabe xft jabe,1503,4,2,2,50,1,HK
fi3nd x godmode,1503,4,2,2,50,1,VS Fighting
crazydog,1503,3,1,2,33,1,CPTA Last Chance Qualifier
coccocco713,1503,4,2,2,50,1,Milan Games Week
rs|cobelcog,1503,10,4,6,40,3,Hypespotting;VS Fighting;EGX
00g juiceman,1503,4,2,2,50,1,CEO
canesmoke,1503,4,2,2,50,1,Milan Games Week
sfo jlm,1503,4,2,2,50,1,EGX
ricky xft_softegg,1503,4,2,2,50,1,HK
jimmy hon maskjimmy,1503,4,2,2,50,1,HK
张嘉程 fat dog,1503,4,2,2,50,1,CPTA Shanghai
stuntastic,1503,4,2,2,50,1,Combo Breaker
doom,1503,4,2,2,50,1,Hypespotting
张鸣 niku,1503,4,2,2,50,1,CPTA Shanghai
nb sol ronin,1503,4,2,2,50,1,Combo Breaker
邢岚 烤鱼,1503,4,2,2,50,1,CPTA Shanghai
dranor,1503,4,2,2,50,1,First Attack
sherman,1503,4,2,2,50,1,CPTA Last Chance Qualifier
yeti,1503,4,2,2,50,1,Northwest Majors
デップー,1503,4,2,2,50,1,Nine States
30f|slayer-san,1503,4,2,2,50,1,Northwest Majors
solphum,1503,4,2,2,50,1,SCR
iz juri,1502,4,2,2,50,1,CPTA Last Chance Qualifier
bcw-gaara_sand,1502,4,2,2,50,1,SCR
ck-vnz,1502,5,2,3,40,1,Saigon Cup
quaka,1502,7,3,4,42,2,EGX;Dreamhack Winter
skz,1502,4,2,2,50,1,CPTA Last Chance Qualifier
rbn|duppsko,1502,12,5,7,41,2,Dreamhack Summer;Call of Ragnarok
方思 ice,1502,4,2,2,50,1,CPTA Shanghai
thamer1977,1502,4,2,2,50,1,KO Fighting Game Festival
sprint,1502,8,4,4,50,2,Hypespotting;VS Fighting
profx,1502,4,2,2,50,1,VS Fighting
voltrix,1502,4,2,2,50,1,FV Cup
dirty dan,1502,4,2,2,50,1,SCR
张意,1502,4,2,2,50,1,Ze Fighting Game Champion
bombskeez,1502,4,2,2,50,1,SCR
blag,1502,4,2,2,50,1,VS Fighting
geomonstaah,1502,4,2,2,50,1,Texas Showdown
dchong,1501,8,4,4,50,2,NorCal Regionals;SCR
raego,1501,4,2,2,50,1,Dreamhack Winter
lau chi hung joe gameouttt,1501,4,2,2,50,1,HK
bsc|hadoshrooms,1501,8,4,4,50,2,Hypespotting;VS Fighting
poncho the blue volcano,1501,3,1,2,33,1,SCR
re:,1501,3,1,2,33,1,Ultra Hyakkishu Cup
ishotto,1501,8,4,4,50,2,Combo Breaker;CEO
boahmad,1501,4,2,2,50,1,KO Fighting Game Festival
pag dragongod,1501,3,1,2,33,1,Summer Jam
dionis8534,1501,4,2,2,50,1,CEO
ultrabram,1501,5,2,3,40,1,Saigon Cup
usin,1501,4,2,2,50,1,CEO
ymb 9 big boss,1500,3,1,2,33,1,Hypespotting
sd legend,1500,3,1,2,33,1,SCR
kage,1500,3,1,2,33,1,CPTA KR
okome man,1500,8,4,4,50,2,Nine States;Ultra Hyakkishu Cup
mdr,1500,3,1,2,33,1,Ultra Hyakkishu Cup
mohamedo,1500,3,1,2,33,1,Ultra Hyakkishu Cup
silg|stanick,1500,11,4,7,36,3,FV Cup;Saigon Cup;CPTA Last Chance Qualifier
dumabalrog,1500,4,2,2,50,1,SCR
スコア,1500,3,1,2,33,1,KSB 2015
forward dash,1500,17,7,10,41,3,Dreamhack Summer;Red Fight District;Dreamhack Winter
rob zfr,1500,8,4,4,50,2,VS Fighting;EGX
yomi saltface,1500,2,1,1,50,1,Combo Breaker
vgp joe love,1500,4,2,2,50,1,Texas Showdown
havocvstheworld,1500,4,2,2,50,1,CEO
emo,1500,4,2,2,50,1,Northwest Majors
なお,1500,3,1,2,33,1,KSB 2015
perplex,1500,3,1,2,33,1,Cannes Winter Clash
阳光少年,1500,3,1,2,33,1,Ze Fighting Game Champion
p skelly,1500,4,2,2,50,1,CEO
kuroda,1500,3,1,2,33,1,Ultra Hyakkishu Cup
黄洁 shermie（虾米）,1500,4,2,2,50,1,HK
もづく,1500,3,1,2,33,1,KSB 2015
allen hunt,1500,4,2,2,50,1,TFC
latiamattner29,1500,3,1,2,33,1,Ze Fighting Game Champion
jackson,1500,4,2,2,50,1,CPTA Last Chance Qualifier
nhem lee,1500,4,2,2,50,1,Texas Showdown
omegastriker,1499,4,2,2,50,1,Combo Breaker
devil reapers jimmy,1499,3,1,2,33,1,Red Fight District
s1ngho,1499,4,2,2,50,1,VS Fighting
ffn kyoku,1499,4,2,2,50,1,SCR
sa karu,1499,4,2,2,50,1,CEO
kenshiro,1499,4,2,2,50,1,Combo Breaker
bryan,1499,4,2,2,50,1,FV Cup
mr. shoushi,1499,4,2,2,50,1,Texas Showdown
salem akuma,1499,4,2,2,50,1,KO Fighting Game Festival
gamachan,1499,3,1,2,33,1,EGX
hlm,1499,3,1,2,33,1,Red Fight District
flb|victor,1499,4,2,2,50,1,VS Fighting
violent repent,1499,4,2,2,50,1,CEO
khio,1499,4,2,2,50,1,SCR
bcw_jmendes,1499,4,2,2,50,1,TFC
spree,1499,4,2,2,50,1,Combo Breaker
chemical ali,1499,4,2,2,50,1,CEO
borralí,1499,4,2,2,50,1,First Attack
arson,1499,4,2,2,50,1,CEO
ua|wholio,1499,4,2,2,50,1,Texas Showdown
xdsc-knowledge,1499,4,2,2,50,1,TFC
nfgc|carnageprincess,1499,4,2,2,50,1,VS Fighting
blue kaizer,1499,4,2,2,50,1,KO Fighting Game Festival
edgyjohnny,1499,4,2,2,50,1,Northwest Majors
aag|baby brasil,1499,2,1,1,50,1,CPT Brazil
alafasy_23,1499,4,2,2,50,1,KO Fighting Game Festival
md calin,1499,4,2,2,50,1,Red Fight District
px|doomed,1499,2,1,1,50,1,True Challengers Costa Rica
keetro,1499,8,4,4,50,2,Combo Breaker;CEO
leon lum,1499,4,2,2,50,1,FV Cup
shockbeast,1499,4,2,2,50,1,SCR
willy,1499,4,2,2,50,1,Taiwan
firefist,1499,4,2,2,50,1,VS Fighting
amaury,1499,4,2,2,50,1,First Attack
unforunatefleshgolem,1499,4,2,2,50,1,Texas Showdown
outlaw,1499,4,2,2,50,1,KO Fighting Game Festival
wyseguy,1499,4,2,2,50,1,Combo Breaker
prk benji,1499,4,2,2,50,1,First Attack
bringbackiceclimbers,1499,4,2,2,50,1,CEO
gdlk.co|churro,1499,4,2,2,50,1,Northwest Majors
srm mad king,1499,4,2,2,50,1,SCR
shogunn,1499,4,2,2,50,1,SCR
koyasu,1499,3,1,2,33,1,Ultra Hyakkishu Cup
ninja musik g,1499,4,2,2,50,1,CPTA KR
justrun,1499,4,2,2,50,1,Texas Showdown
scc|unw4nt3d,1499,4,2,2,50,1,VS Fighting
masterninja,1499,4,2,2,50,1,Texas Showdown
dean of games,1499,4,2,2,50,1,Northwest Majors
rde|samurai drew,1499,4,2,2,50,1,Hypespotting
赵渭炯 小迷,1499,4,2,2,50,1,CPTA Shanghai
ds|jamusan,1499,4,2,2,50,1,VS Fighting
swk fbruce,1499,4,2,2,50,1,Combo Breaker
tierproblem,1499,4,2,2,50,1,Texas Showdown
rs|ladnopoka,1499,4,2,2,50,1,Hypespotting
team seaslug,1498,11,5,6,45,3,NorCal Regionals;Texas Showdown;CEO
wong tin pui shiro fans,1498,4,2,2,50,1,HK
saltybetts,1498,4,2,2,50,1,Combo Breaker
jayto,1498,4,2,2,50,1,Texas Showdown
javy jitters,1498,4,2,2,50,1,First Attack
formerlyunknown,1498,4,2,2,50,1,TFC
ifd humbag,1498,4,2,2,50,1,Combo Breaker
final tick,1498,4,2,2,50,1,TFC
crisium,1498,4,2,2,50,1,Texas Showdown
仮面の魔術師,1498,4,2,2,50,1,Nine States
xdsc-knowledgereup,1498,4,2,2,50,1,CEO
林諾勤 kennklam,1498,4,2,2,50,1,HK
小宝,1498,4,2,2,50,1,Ze Fighting Game Champion
linux,1498,4,2,2,50,1,Combo Breaker
sfo|tiger flowsion,1498,4,2,2,50,1,VS Fighting
邬可夫 阿修,1498,2,1,1,50,1,HK
kwok sui tak barrytak,1498,4,2,2,50,1,HK
jthamind,1498,4,2,2,50,1,Combo Breaker
chenxin gouzi,1498,4,2,2,50,1,CPTA Shanghai
white fang,1498,3,1,2,33,1,Ultra Hyakkishu Cup
daymo,1498,4,2,2,50,1,CEO
kristougher,1498,4,2,2,50,1,TFC
snx,1498,4,2,2,50,1,VS Fighting
misak,1498,4,2,2,50,1,Combo Breaker
big poe,1498,4,2,2,50,1,Texas Showdown
venomkiller,1498,4,2,2,50,1,CPTA Last Chance Qualifier
sa shank,1498,4,2,2,50,1,CEO
leadman,1498,4,2,2,50,1,Combo Breaker
burger time,1498,4,2,2,50,1,Combo Breaker
vs roy,1498,4,2,2,50,1,Combo Breaker
rize|ind|mug|rdubstepper,1498,4,2,2,50,1,Hypespotting
battlefelde,1498,4,2,2,50,1,Combo Breaker
mn somemexicanguy,1498,4,2,2,50,1,Combo Breaker
summer xft_summer,1498,4,2,2,50,1,HK
wmd|mom's spaghetti,1498,4,2,2,50,1,NorCal Regionals
shogun dynamite,1498,4,2,2,50,1,CEO
panoptic,1498,4,2,2,50,1,SCR
revolver sagod,1498,4,2,2,50,1,NorCal Regionals
ナックル nakkuru,1498,4,2,2,50,1,Nine States
kaara,1498,4,2,2,50,1,Ultra Hyakkishu Cup
chan shing chi xft_sonicbeta,1498,4,2,2,50,1,HK
南哥的小戀人/陳二,1498,4,2,2,50,1,Taiwan
bomsa,1498,4,2,2,50,1,KO Fighting Game Festival
ipg|dcb staticgorilla,1498,4,2,2,50,1,Northwest Majors
raoul,1498,4,2,2,50,1,NorCal Regionals
小布,1498,4,2,2,50,1,Taiwan
mikejay,1498,4,2,2,50,1,SCR
demonlos,1498,4,2,2,50,1,NorCal Regionals
banto,1498,4,2,2,50,1,Combo Breaker
dm|katzu,1498,4,2,2,50,1,NorCal Regionals
豆腐 tofu,1498,4,2,2,50,1,Nine States
bloodyziff,1498,4,2,2,50,1,SCR
no-leaf_clover76,1498,3,1,2,33,1,CPTA KR
surgingstorm,1498,4,2,2,50,1,TFC
dante dt,1498,5,2,3,40,1,CPTA Shanghai
sml|shinmael,1498,4,2,2,50,1,VS Fighting
sfo zxmx,1498,4,2,2,50,1,Hypespotting
hydro,1498,4,2,2,50,1,NorCal Regionals
the steam co|bacardi,1498,4,2,2,50,1,First Attack
sft|alexandro,1498,2,1,1,50,1,CPT Brazil
fairlysadpanda,1498,4,2,2,50,1,Hypespotting
knix,1498,12,5,7,41,2,Dreamhack Summer;Dreamhack Winter
もふもふ,1498,4,2,2,50,1,Nine States
nsm fancyyancy,1498,4,2,2,50,1,CEO
crustiestwolf33,1498,4,2,2,50,1,Taiwan
lele,1498,4,2,2,50,1,Taiwan
soa|caju,1498,3,1,2,33,1,CPT Brazil
suddenblackout,1498,4,2,2,50,1,NorCal Regionals
操查理,1498,4,2,2,50,1,Taiwan
twmsp,1498,4,2,2,50,1,Taiwan
dm|willpower,1498,6,3,3,50,2,NorCal Regionals;EVO
noodles,1498,4,2,2,50,1,VS Fighting
omg itz andre,1498,4,2,2,50,1,Combo Breaker
jkazuma,1498,4,2,2,50,1,KO Fighting Game Festival
greedychun,1498,4,2,2,50,1,Combo Breaker
wang,1498,4,2,2,50,1,Ze Fighting Game Champion
ssj hotdog,1498,4,2,2,50,1,CEO
(setx) willcola,1498,4,2,2,50,1,Texas Showdown
aldenteoh,1498,4,2,2,50,1,FV Cup
ben ho,1498,4,2,2,50,1,Texas Showdown
mr|jetpackjohnny,1498,4,2,2,50,1,NorCal Regionals
ash,1498,4,2,2,50,1,Hypespotting
jh maxninja,1498,4,2,2,50,1,CEO
ybk|shin,1498,3,1,2,33,1,Ultra Hyakkishu Cup
vilmon,1498,4,2,2,50,1,Northwest Majors
hero504,1498,4,2,2,50,1,Texas Showdown
rice_crackers,1498,4,2,2,50,1,NorCal Regionals
tez,1498,4,2,2,50,1,Northwest Majors
ink7,1498,6,3,3,50,1,CPTA KR
dm|burn notice,1498,4,2,2,50,1,NorCal Regionals
rs|ayjayirl,1498,4,2,2,50,1,Hypespotting
無刑,1498,4,2,2,50,1,Nine States
lk,1498,4,2,2,50,1,Saigon Cup
flan,1498,4,2,2,50,1,First Attack
wh vicious,1498,4,2,2,50,1,Combo Breaker
google_deez,1498,4,2,2,50,1,CEO
brz rattosai,1498,4,2,2,50,1,First Attack
zaybak,1498,4,2,2,50,1,Combo Breaker
jnana,1498,4,2,2,50,1,Taiwan
dmt - mr. d,1498,4,2,2,50,1,SCR
onslaught,1498,4,2,2,50,1,NorCal Regionals
moony blues,1498,4,2,2,50,1,Combo Breaker
eminent,1498,4,2,2,50,1,CEO
sa tempun,1498,4,2,2,50,1,CEO
fera,1498,4,2,2,50,1,NorCal Regionals
rinbo7,1498,4,2,2,50,1,CPTA KR
@theb00st,1498,4,2,2,50,1,Combo Breaker
ep1cp33,1498,4,2,2,50,1,CEO
khadell,1498,4,2,2,50,1,CEO
threecentipedes,1498,4,2,2,50,1,NorCal Regionals
streetmonkeys hekiat,1498,3,1,2,33,1,Red Fight District
lin先生,1498,4,2,2,50,1,Taiwan
maxoplata,1498,4,2,2,50,1,SCR
gvoice,1498,4,2,2,50,1,KO Fighting Game Festival
deja fait,1498,4,2,2,50,1,CEO
bcw-carlos danger,1498,4,2,2,50,1,SCR
sa projectsik,1498,4,2,2,50,1,CEO
dawgenhower,1498,4,2,2,50,1,Texas Showdown
icg redvelvet,1498,4,2,2,50,1,Texas Showdown
kingdomkey92,1498,4,2,2,50,1,SCR
jlm,1498,4,2,2,50,1,Hypespotting
gka soul below,1498,4,2,2,50,1,Combo Breaker
ttf|jamaal jackson,1498,4,2,2,50,1,SCR
sulabee,1498,4,2,2,50,1,Taiwan
yomi excited beast,1498,7,3,4,42,2,CEO;TFC
keane_hi,1498,4,2,2,50,1,FV Cup
lord devil,1498,4,2,2,50,1,KO Fighting Game Festival
tkr_doukhi,1498,4,2,2,50,1,KO Fighting Game Festival
od|hollow,1498,4,2,2,50,1,First Attack
norcal joe,1498,4,2,2,50,1,NorCal Regionals
anbu_mrfrayfray,1498,4,2,2,50,1,TFC
vincent,1498,4,2,2,50,1,CPTA Shanghai
misteranthropy,1498,4,2,2,50,1,NorCal Regionals
ed|undeadjim,1498,4,2,2,50,1,VS Fighting
design,1498,4,2,2,50,1,CEO
bram,1498,4,2,2,50,1,FV Cup
schmoo,1498,4,2,2,50,1,Combo Breaker
johnnylamonte,1498,4,2,2,50,1,Texas Showdown
alex turner,1498,4,2,2,50,1,CEO
zhudongyu,1498,4,2,2,50,1,CPTA Shanghai
onetimehero,1498,3,1,2,33,1,NorCal Regionals
nick t.,1498,4,2,2,50,1,Combo Breaker
vx,1498,3,1,2,33,1,Milan Games Week
jing,1498,4,2,2,50,1,CPTA Shanghai
nate fearless,1498,4,2,2,50,1,CEO
negator,1498,4,2,2,50,1,Taiwan
mdz ricky,1497,3,1,2,33,1,Red Fight District
ebomb,1497,7,3,4,42,2,Northwest Majors;SCR
haw seow,1497,7,3,4,42,2,FV Cup;CPTA Last Chance Qualifier
ac riki-oh,1497,4,2,2,50,1,Northwest Majors
tiger uppercut,1497,3,1,2,33,1,Saigon Cup
maromas mxl,1497,4,2,2,50,1,SCR
charisma,1497,3,1,2,33,1,Ultra Hyakkishu Cup
enfont pordu a easyman,1497,4,2,2,50,1,Red Fight District
ugc hellfyre,1497,3,1,2,33,1,SCR
ずん,1497,3,1,2,33,1,KSB 2015
ed|noonez,1497,4,2,2,50,1,VS Fighting
wagahai,1497,4,2,2,50,1,TFC
mk tux,1497,4,2,2,50,1,VS Fighting
みだれねこ,1497,3,1,2,33,1,KSB 2015
jacky cannons,1497,4,2,2,50,1,Combo Breaker
noobiex,1497,4,2,2,50,1,Saigon Cup
susubabi,1497,3,1,2,33,1,Abuget Cup
jaguar_murad,1497,4,2,2,50,1,KO Fighting Game Festival
revolver dropsalot,1497,4,2,2,50,1,CEO
across,1497,3,1,2,33,1,Ultra Hyakkishu Cup
cloud9,1497,1,0,1,0,1,EVO
daiki matsubara so,1497,4,2,2,50,1,HK
郑诚 lutak,1497,4,2,2,50,1,CPTA Shanghai
the professional,1497,5,2,3,40,1,Texas Showdown
dave o,1497,7,3,4,42,2,Northwest Majors;Combo Breaker
fgc|bean,1496,6,2,4,33,2,South East Asia Major;Ultra Hyakkishu Cup
kubisa,1496,4,2,2,50,1,VS Fighting
hishow rabbit,1496,3,1,2,33,1,Ultra Hyakkishu Cup
wahlau,1496,3,1,2,33,1,FV Cup
801 mr gork,1496,8,4,4,50,2,NorCal Regionals;Northwest Majors
cenerebb,1496,3,1,2,33,1,Milan Games Week
torimeshi,1496,3,1,2,33,1,Ultra Hyakkishu Cup
sfo|willo,1496,3,1,2,33,1,Hypespotting
noriyasu,1496,3,1,2,33,1,Ultra Hyakkishu Cup
beastchan23,1496,3,1,2,33,1,Texas Showdown
rde|sddowns,1496,7,3,4,42,2,Hypespotting;VS Fighting
dr. b,1496,1,0,1,0,1,EVO
cheng chun hung 天下布武,1496,3,1,2,33,1,HK
koryu,1495,3,1,2,33,1,NorCal Regionals
pie|sci,1495,1,0,1,0,1,Defend the North
mdz|emtpysys,1495,1,0,1,0,1,FFM-Rumble
pie|poem,1495,4,1,3,25,2,Defend the North;Canada Cup
威哥,1495,3,1,2,33,1,Ze Fighting Game Champion
setx 199x survivor pro,1495,3,1,2,33,1,Texas Showdown
dojo_got_trees,1495,3,1,2,33,1,NorCal Regionals
ks|tali,1495,1,0,1,0,1,Defend the North
tr mac,1495,4,1,3,25,2,FFM-Rumble;Red Fight District
zelpher,1495,8,3,5,37,1,Dreamhack Summer
tc507|kakaroto,1495,3,1,2,33,1,True Challengers Costa Rica
armageddon8,1495,3,1,2,33,1,NorCal Regionals
jorge arana,1495,3,1,2,33,1,Milan Games Week
tosfhq|general luke,1495,1,0,1,0,1,Canada Cup
pedram,1495,3,1,2,33,1,Call of Ragnarok
coldvoid,1495,3,1,2,33,1,Combo Breaker
leland,1495,3,1,2,33,1,CEO
wtq8|jaber,1495,3,1,2,33,1,KO Fighting Game Festival
macabremonster,1495,3,1,2,33,1,SCR
rbn|bliredd,1495,3,1,2,33,1,Call of Ragnarok
j8slim,1495,3,1,2,33,1,TFC
chris nguyen,1495,3,1,2,33,1,SCR
ひかりん,1495,3,1,2,33,1,KSB 2015
theprince4d,1495,1,0,1,0,1,Canada Cup
chris tweten ctwtn,1495,3,1,2,33,1,CPTA Shanghai
joker,1495,7,3,4,42,2,First Attack;Milan Games Week
cex|goukifafa,1495,14,7,7,50,3,Hypespotting;VS Fighting;Red Fight District
oc 919,1495,3,1,2,33,1,TFC
tosfhq|jimmy fierce,1495,1,0,1,0,1,Canada Cup
izumi kouta,1494,3,1,2,33,1,Ultra Hyakkishu Cup
theory fighter,1494,3,1,2,33,1,EGX
yoshio,1494,3,1,2,33,1,Milan Games Week
lost boy,1494,3,1,2,33,1,Texas Showdown
765p fizzykups,1494,3,1,2,33,1,CEO
david copperfield,1494,3,1,2,33,1,Taiwan
パスタ3,1494,3,1,2,33,1,KSB 2015
ldo,1494,3,1,2,33,1,NorCal Regionals
almond42,1494,3,1,2,33,1,CPTA KR
al,1494,3,1,2,33,1,CPTA KR
cyberchink,1494,3,1,2,33,1,NorCal Regionals
sfo ghost,1494,3,1,2,33,1,EGX
alkaline,1494,3,1,2,33,1,NorCal Regionals
red_panda_0bjection,1494,3,1,2,33,1,TFC
tatsushoryu,1494,3,1,2,33,1,SCR
徐健 xj,1494,3,1,2,33,1,CPTA Shanghai
babaghanoush1985,1494,3,1,2,33,1,SCR
きょく,1494,3,1,2,33,1,KSB 2015
schiacci sempre,1494,3,1,2,33,1,Milan Games Week
money martinez,1494,3,1,2,33,1,Texas Showdown
sft|fabinho,1494,1,0,1,0,1,CPT Brazil
jiji,1494,3,1,2,33,1,VS Fighting
ahbao,1494,1,0,1,0,1,HK
baoice,1494,1,0,1,0,1,HK
frank the tank,1494,3,1,2,33,1,TFC
acidrock,1494,3,1,2,33,1,FV Cup
franky,1494,3,1,2,33,1,SCR
tomarre,1494,3,1,2,33,1,SCR
inc rollynx,1494,3,1,2,33,1,CPTA Last Chance Qualifier
郭大喜,1494,3,1,2,33,1,Ze Fighting Game Champion
pine,1494,3,1,2,33,1,Saigon Cup
fv tkc,1494,3,1,2,33,1,FV Cup
tlc|saga,1494,1,0,1,0,1,EVO
dm|mr. tails,1494,3,1,2,33,1,NorCal Regionals
jan,1494,3,1,2,33,1,CPTA Last Chance Qualifier
775 ya0,1494,3,1,2,33,1,NorCal Regionals
sfo|dragonman,1494,3,1,2,33,1,VS Fighting
tsc|ifc yipes,1494,1,0,1,0,1,Final Round
张翔渝 freeman,1494,3,1,2,33,1,HK
dm|soothsayer,1494,3,1,2,33,1,NorCal Regionals
tekateka,1494,3,1,2,33,1,Ultra Hyakkishu Cup
xzalis,1494,3,1,2,33,1,CEO
shougai adashi-ku min,1494,3,1,2,33,1,Ultra Hyakkishu Cup
min,1493,1,0,1,0,1,Final Round
clowd,1493,3,1,2,33,1,SCR
big betty swalls,1493,3,1,2,33,1,Northwest Majors
gd just joe,1493,3,1,2,33,1,SCR
detroit coco,1493,3,1,2,33,1,Texas Showdown
tommy chiam,1493,3,1,2,33,1,FV Cup
small tom 細tommy,1493,3,1,2,33,1,HK
bye,1493,3,1,2,33,1,VS Fighting
丫合,1493,3,1,2,33,1,Taiwan
pag|glitch,1493,1,0,1,0,1,Defend the North
shredded manlet,1493,3,1,2,33,1,Hypespotting
saturnize,1493,7,3,4,42,2,Northwest Majors;SCR
jewelman,1493,1,0,1,0,1,EVO
眉山拳王1,1493,1,0,1,0,1,Ze Fighting Game Champion
apocaalypse,1493,7,3,4,42,2,NorCal Regionals;Northwest Majors
tsid n8theoreat,1493,3,1,2,33,1,SCR
lai chun wai neverdiewai,1493,3,1,2,33,1,HK
tuna,1493,3,1,2,33,1,Ultra Hyakkishu Cup
rm|saltface,1493,1,0,1,0,1,Final Round
samzo,1493,3,1,2,33,1,Texas Showdown
直播弟,1493,3,1,2,33,1,Ze Fighting Game Champion
gutter trash,1493,3,1,2,33,1,Northwest Majors
陈桓,1493,3,1,2,33,1,Ze Fighting Game Champion
chiu sung hong gexp,1493,3,1,2,33,1,HK
mba|ermok,1493,3,1,2,33,1,VS Fighting
zzlnsanezz,1493,3,1,2,33,1,CPTA KR
kisaran,1493,3,1,2,33,1,Ultra Hyakkishu Cup
realvocalist,1493,3,1,2,33,1,CPTA KR
danilo,1493,3,1,2,33,1,Milan Games Week
cptmaumau,1493,3,1,2,33,1,CPTA KR
masterwho,1493,3,1,2,33,1,Combo Breaker
peluco,1493,3,1,2,33,1,First Attack
honda tropical,1493,3,1,2,33,1,First Attack
jimmy89,1493,3,1,2,33,1,Milan Games Week
cevo,1493,3,1,2,33,1,Red Fight District
minde,1493,3,1,2,33,1,Taiwan
leonlum,1493,3,1,2,33,1,CPTA Last Chance Qualifier
rs ayjayirl,1493,3,1,2,33,1,EGX
sfo broodoo,1493,7,3,4,42,2,Hypespotting;EGX
ne yooyoung,1493,3,1,2,33,1,Combo Breaker
jappa,1493,3,1,2,33,1,First Attack
guggemamol,1493,3,1,2,33,1,Red Fight District
kenneth lai thunder 9,1493,3,1,2,33,1,HK
willis,1493,3,1,2,33,1,HK
drake von duke,1493,3,1,2,33,1,CEO
krs t3p valiant,1493,3,1,2,33,1,CEO
dmひでぶ～,1493,3,1,2,33,1,Nine States
winston chen,1493,3,1,2,33,1,Taiwan
ctrl b,1493,3,1,2,33,1,Red Fight District
daddy-sensei,1493,3,1,2,33,1,Red Fight District
dunham,1493,3,1,2,33,1,TFC
张灂曦,1492,3,1,2,33,1,Ze Fighting Game Champion
dianminion,1492,3,1,2,33,1,FV Cup
oneaboveall ad,1492,3,1,2,33,1,Texas Showdown
mek,1492,3,1,2,33,1,Northwest Majors
kindou,1492,1,0,1,0,1,Tokyo Game Show
２４７,1492,3,1,2,33,1,Nine States
mattdaddy916,1492,3,1,2,33,1,NorCal Regionals
maxima,1492,3,1,2,33,1,Taiwan
rosso,1492,3,1,2,33,1,Call of Ragnarok
kontoru,1492,3,1,2,33,1,Saigon Cup
juggernaughty,1492,3,1,2,33,1,NorCal Regionals
ralstaanley,1492,3,1,2,33,1,CEO
talkbow,1492,3,1,2,33,1,Taiwan
krisimbored,1492,3,1,2,33,1,Texas Showdown
buktooth,1492,1,0,1,0,1,EVO
downbackbro,1492,3,1,2,33,1,VS Fighting
nb|souji,1492,1,0,1,0,1,EVO
cameraman,1492,10,4,6,40,3,Abuget Cup;CPTA KR;Milan Games Week
ks|cbrn|nighttwo,1492,3,1,2,33,1,NorCal Regionals
kb8,1492,3,1,2,33,1,Taiwan
吴滨 marstv.cornetto,1492,3,1,2,33,1,CPTA Shanghai
qcb|klitschko,1492,1,0,1,0,1,Defend the North
ardi,1492,3,1,2,33,1,Abuget Cup
sfo willo,1492,3,1,2,33,1,EGX
moonflow,1492,3,1,2,33,1,Saigon Cup
aag|pr3da,1492,3,1,2,33,1,CPT Brazil
cord krohn ahgama,1492,3,1,2,33,1,HK
chewmandinga,1492,3,1,2,33,1,Hypespotting
madchewie,1492,3,1,2,33,1,NorCal Regionals
sa ghost,1492,3,1,2,33,1,CEO
ぬ。nu,1492,3,1,2,33,1,Nine States
stiqman,1492,3,1,2,33,1,SCR
gootecks,1492,1,0,1,0,1,EVO
キヌイト,1492,3,1,2,33,1,Nine States
iplay|maruko,1492,1,0,1,0,1,FFM-Rumble
volg,1492,3,1,2,33,1,CPTA KR
lexblade,1492,3,1,2,33,1,CPTA Last Chance Qualifier
goldencen,1492,1,0,1,0,1,EVO
skullied,1492,3,1,2,33,1,NorCal Regionals
spano,1492,3,1,2,33,1,Saigon Cup
madana pc,1492,3,1,2,33,1,CPTA KR
jmasters,1492,3,1,2,33,1,Hypespotting
papo,1492,3,1,2,33,1,CEO
zalk,1492,3,1,2,33,1,Taiwan
alistarr,1492,3,1,2,33,1,Hypespotting
cooki3monster,1492,1,0,1,0,1,EVO
lueshi,1492,3,1,2,33,1,Northwest Majors
tss hbic,1492,3,1,2,33,1,Texas Showdown
abelity,1492,3,1,2,33,1,FV Cup
かいひも,1492,3,1,2,33,1,Nine States
sho thesolgoodguy,1492,3,1,2,33,1,Combo Breaker
moor,1492,5,2,3,40,1,Milan Games Week
john,1492,3,1,2,33,1,Milan Games Week
wtq8|ramadan,1492,3,1,2,33,1,KO Fighting Game Festival
nyc vega,1492,3,1,2,33,1,TFC
吴浩群 gz维尼,1492,3,1,2,33,1,CPTA Shanghai
ya3goob,1492,3,1,2,33,1,KO Fighting Game Festival
brasssmunkye,1492,3,1,2,33,1,NorCal Regionals
ペルシャ,1492,3,1,2,33,1,KSB 2015
rde oscar,1492,3,1,2,33,1,Hypespotting
jason liu satc1014,1492,3,1,2,33,1,HK
ne.pxg synapsse,1491,3,1,2,33,1,Combo Breaker
tarezou,1491,6,2,4,33,2,KSB 2015;Ultra Hyakkishu Cup
mr. sparkle,1491,3,1,2,33,1,NorCal Regionals
ninjamatic,1491,3,1,2,33,1,NorCal Regionals
めろんそーだ meronn soda,1491,3,1,2,33,1,Nine States
romfinite,1491,3,1,2,33,1,SCR
ed|wilksy15,1491,7,3,4,42,2,Hypespotting;VS Fighting
rf,1491,3,1,2,33,1,KSB 2015
dm|casual phil,1491,3,1,2,33,1,NorCal Regionals
dinasaur king,1491,3,1,2,33,1,Hypespotting
yo_snax,1491,5,2,3,40,1,SCR
joutai,1491,3,1,2,33,1,NorCal Regionals
rst mambo penguin,1491,3,1,2,33,1,Hypespotting
almulla,1491,3,1,2,33,1,KO Fighting Game Festival
rmfluffy,1491,3,1,2,33,1,NorCal Regionals
ymb9 dutchie,1491,3,1,2,33,1,Hypespotting
dm|nothing man,1491,3,1,2,33,1,NorCal Regionals
chromo,1491,3,1,2,33,1,NorCal Regionals
muratto,1491,3,1,2,33,1,NorCal Regionals
huomaotv jiewa,1491,2,0,2,0,1,South East Asia Major
maxipoo,1491,3,1,2,33,1,Texas Showdown
phs buster chen,1491,3,1,2,33,1,Texas Showdown
jen,1491,3,1,2,33,1,CPTA Last Chance Qualifier
color,1491,3,1,2,33,1,CPTA Shanghai
smbf nebbiez,1491,3,1,2,33,1,EGX
foolycooly2,1491,3,1,2,33,1,Ultra Hyakkishu Cup
militarymind510,1491,3,1,2,33,1,NorCal Regionals
vapourzz i,1491,3,1,2,33,1,VS Fighting
harris yung kuchi82,1491,3,1,2,33,1,HK
elliot heath,1491,3,1,2,33,1,CEO
blaqacid,1491,3,1,2,33,1,Combo Breaker
hmd1050,1491,3,1,2,33,1,Red Fight District
very good tanaka,1491,3,1,2,33,1,Ultra Hyakkishu Cup
具体哥,1491,3,1,2,33,1,Ze Fighting Game Champion
my mom says i'm pro,1491,3,1,2,33,1,NorCal Regionals
phdeejay (no psn id),1491,3,1,2,33,1,CPTA KR
aho,1491,3,1,2,33,1,Abuget Cup
ambush,1491,3,1,2,33,1,NorCal Regionals
ceo,1491,3,1,2,33,1,Ze Fighting Game Champion
koh kok sun,1491,3,1,2,33,1,FV Cup
drunkenbanana,1491,3,1,2,33,1,Northwest Majors
jgt1201,1491,3,1,2,33,1,Hypespotting
bidoofshock,1491,3,1,2,33,1,SCR
scavenger xiii,1491,3,1,2,33,1,Hypespotting
jonodori,1491,3,1,2,33,1,Combo Breaker
muirtron,1491,3,1,2,33,1,Hypespotting
johnny xrd,1491,3,1,2,33,1,Combo Breaker
coffee,1491,3,1,2,33,1,CPTA Last Chance Qualifier
jkd,1491,3,1,2,33,1,NorCal Regionals
tom90957-tw,1491,3,1,2,33,1,Taiwan
thezuluwarrior,1491,3,1,2,33,1,VS Fighting
cuby,1491,2,0,2,0,1,Summer Jam
romora,1491,3,1,2,33,1,Northwest Majors
tss cambam,1490,3,1,2,33,1,Texas Showdown
xanoz,1490,3,1,2,33,1,CEO
aron mike,1490,3,1,2,33,1,Texas Showdown
sff|goshtin,1490,3,1,2,33,1,VS Fighting
zachinabox,1490,3,1,2,33,1,Combo Breaker
papatiwawa,1490,2,0,2,0,1,South East Asia Major
aes|nolafrog,1490,7,3,4,42,2,Texas Showdown;CEO
sol,1490,3,1,2,33,1,Hypespotting
pnd|i2 gaug3,1490,3,1,2,33,1,VS Fighting
og|mastermikee21,1490,2,0,2,0,1,Defend the North
asunyan,1490,3,1,2,33,1,Ultra Hyakkishu Cup
fv|mark,1490,7,3,4,42,2,FV Cup;Saigon Cup
kermit alexander,1490,7,3,4,42,2,Texas Showdown;Combo Breaker
kit potato salad,1490,7,3,4,42,2,CEO;TFC
cupcake panda,1490,3,1,2,33,1,Texas Showdown
kevin lee,1490,3,1,2,33,1,FV Cup
jlc,1490,3,1,2,33,1,Hypespotting
lom|slim,1490,3,1,2,33,1,VS Fighting
frs,1490,2,0,2,0,1,CPTA KR
rs nutrient,1490,3,1,2,33,1,EGX
daniel butterworth,1490,3,1,2,33,1,Nine States
annoobilation,1490,3,1,2,33,1,Red Fight District
fullmetal-alex,1490,3,1,2,33,1,Northwest Majors
hellamindgames choi,1490,2,0,2,0,1,NorCal Regionals
tws|tws gibbo,1489,7,3,4,42,2,Hypespotting;VS Fighting
f99|tim,1489,4,1,3,25,2,EVO;Taiwan
ipt.garret,1489,2,0,2,0,1,Manila Cup
bfl|popidge,1489,7,3,4,42,2,Hypespotting;VS Fighting
c0ckman007,1489,4,1,3,25,1,Dreamhack Winter
burnoutfighter,1489,3,1,2,33,1,CPTA Last Chance Qualifier
ipt.dru,1489,2,0,2,0,1,Manila Cup
a$ap rabbitos,1489,1,0,1,0,1,Combo Breaker
tani,1489,3,1,2,33,1,VS Fighting
ＭＡＳＴ,1489,2,0,2,0,1,KSB 2015
cltn sl1m,1488,3,1,2,33,1,CEO
lk sobat,1488,3,1,2,33,1,VS Fighting
tryken,1488,3,1,2,33,1,CEO
big marcus,1488,2,0,2,0,1,Combo Breaker
phd zeal,1488,3,1,2,33,1,Northwest Majors
david alvarez,1488,3,1,2,33,1,SCR
james,1488,2,0,2,0,1,Manila Cup
nashi,1488,2,0,2,0,1,Ultra Hyakkishu Cup
sp|teiga,1488,1,0,1,0,1,Defend the North
seriphx,1488,3,1,2,33,1,TFC
gameguys danny express,1488,3,1,2,33,1,Texas Showdown
street4game master ziane,1488,2,0,2,0,1,Red Fight District
atrosh,1488,4,1,3,25,1,Dreamhack Winter
ed ma,1488,2,0,2,0,1,Canada Cup
郭嘉成 hksiushingshing,1488,3,1,2,33,1,HK
confz,1488,10,4,6,40,3,VS Fighting;Red Fight District;Milan Games Week
v.s. lorde gamer,1487,3,1,2,33,1,SCR
player32,1487,1,0,1,0,1,South East Asia Major
ctrl rayray,1487,7,3,4,42,2,Texas Showdown;CEO
kuraudokin,1487,3,1,2,33,1,Taiwan
marn,1487,1,0,1,0,1,Saigon Cup
on|gabo,1487,1,0,1,0,1,True Challengers Costa Rica
ch|nigma,1487,1,0,1,0,1,True Challengers Costa Rica
kaiser rose,1487,3,1,2,33,1,CEO
2iq|discount marx,1487,3,1,2,33,1,Texas Showdown
天津飯,1487,6,2,4,33,1,Nine States
angel,1487,3,1,2,33,1,Texas Showdown
jblaze,1487,3,1,2,33,1,CEO
phuong,1487,3,1,2,33,1,Saigon Cup
沈艺洵 dabaipang,1487,3,1,2,33,1,CPTA Shanghai
白莽 孤高的双子座英雄,1487,3,1,2,33,1,CPTA Shanghai
shido_,1487,3,1,2,33,1,KO Fighting Game Festival
condit,1487,3,1,2,33,1,CEO
daisuketensei,1487,3,1,2,33,1,Texas Showdown
chris belman,1487,3,1,2,33,1,Texas Showdown
setx|dlowe,1487,3,1,2,33,1,Texas Showdown
soulash,1487,1,0,1,0,1,KO Fighting Game Festival
rick masters,1487,3,1,2,33,1,TFC
iigtrii,1487,3,1,2,33,1,KO Fighting Game Festival
peter sauce,1487,3,1,2,33,1,Texas Showdown
srd|blahblah,1487,3,1,2,33,1,TFC
bloodzure,1487,3,1,2,33,1,CEO
kungfutreachery,1487,3,1,2,33,1,Texas Showdown
jun10r123,1487,3,1,2,33,1,CEO
knifelife,1487,3,1,2,33,1,CEO
rinda wan,1487,3,1,2,33,1,FV Cup
jmob,1487,3,1,2,33,1,CEO
blackcus,1487,3,1,2,33,1,FV Cup
朱忠旻 ps手柄渣,1487,3,1,2,33,1,CPTA Shanghai
brz|dj basket,1487,3,1,2,33,1,First Attack
kingblack,1487,3,1,2,33,1,CEO
そらネ�,1487,1,0,1,0,1,Nine States
snoop,1487,3,1,2,33,1,CEO
pdx waifu mobile (goggles),1487,3,1,2,33,1,Northwest Majors
minoxxx,1487,3,1,2,33,1,Milan Games Week
bryanpro,1487,3,1,2,33,1,Milan Games Week
rchan,1487,3,1,2,33,1,CPTA Last Chance Qualifier
canjs|cxr|bionicfraud,1487,3,1,2,33,1,Northwest Majors
rawpower,1487,3,1,2,33,1,Milan Games Week
zay,1487,3,1,2,33,1,CEO
cuddles|fadc|nasty,1487,3,1,2,33,1,Northwest Majors
siamawich,1487,3,1,2,33,1,CEO
hola bird,1487,3,1,2,33,1,Combo Breaker
lom|vegedow,1487,7,3,4,42,2,VS Fighting;EGX
el ben,1487,3,1,2,33,1,NorCal Regionals
funnylookinwhat,1487,3,1,2,33,1,CEO
25 r3dgy,1487,3,1,2,33,1,SCR
mlp triox,1487,3,1,2,33,1,SCR
boti,1487,3,1,2,33,1,First Attack
sfo|nargrull,1487,3,1,2,33,1,VS Fighting
lilman,1487,3,1,2,33,1,CEO
guiseppe,1487,1,0,1,0,1,Combo Breaker
4bidden,1487,3,1,2,33,1,First Attack
kalbibeef,1487,3,1,2,33,1,SCR
sfhappyfeet,1487,3,1,2,33,1,CEO
jarocka,1487,3,1,2,33,1,CEO
parable greg,1487,6,2,4,33,2,Hypespotting;Red Fight District
dark hokage,1487,3,1,2,33,1,CEO
misfitpenguin,1487,3,1,2,33,1,CEO
cg_sonicboom,1487,3,1,2,33,1,Combo Breaker
kenneth hernandez,1487,3,1,2,33,1,First Attack
zoke16,1487,3,1,2,33,1,First Attack
g. summer,1487,3,1,2,33,1,SCR
taxto,1487,3,1,2,33,1,First Attack
sww|tearod,1487,3,1,2,33,1,VS Fighting
plu,1487,3,1,2,33,1,SCR
sft|dark817,1487,1,0,1,0,1,CPT Brazil
kamoshio,1487,1,0,1,0,1,EVO
king of the jews,1487,3,1,2,33,1,Hypespotting
ltwins|xitao,1487,1,0,1,0,1,CPT Brazil
sft|jacare,1487,1,0,1,0,1,CPT Brazil
tekei,1487,4,1,3,25,1,Dreamhack Winter
kokujin,1487,1,0,1,0,1,EVO
nb slimetime,1487,3,1,2,33,1,Combo Breaker
smbf|cogs quora,1487,3,1,2,33,1,VS Fighting
ug|djvest,1487,1,0,1,0,1,EVO
陈俊宇 藏人,1487,3,1,2,33,1,HK
roukanken,1487,3,1,2,33,1,Hypespotting
the beav,1487,3,1,2,33,1,CEO
setx - mugs,1486,3,1,2,33,1,Texas Showdown
chau pui hing jeono,1486,3,1,2,33,1,HK
rs|mikenyan,1486,3,1,2,33,1,Hypespotting
okira,1486,3,1,2,33,1,Combo Breaker
zero_hour,1486,3,1,2,33,1,NorCal Regionals
666,1486,3,1,2,33,1,Ultra Hyakkishu Cup
uvg the professional,1486,3,1,2,33,1,CEO
firstnevermore,1486,3,1,2,33,1,NorCal Regionals
ds|gutsy,1486,3,1,2,33,1,VS Fighting
hardtymze,1486,3,1,2,33,1,NorCal Regionals
rbr anbu deadlyclaw,1486,3,1,2,33,1,CEO
ne miasma,1486,3,1,2,33,1,Combo Breaker
sww|axythetaxi,1486,3,1,2,33,1,VS Fighting
rush digital,1486,3,1,2,33,1,CEO
bcw-rapidrunx,1486,3,1,2,33,1,NorCal Regionals
notorious a.l.b,1486,3,1,2,33,1,VS Fighting
dr. z,1486,3,1,2,33,1,CEO
romeo,1486,3,1,2,33,1,NorCal Regionals
hacken law xft_hacken_jp,1486,3,1,2,33,1,HK
saor (ireland),1486,3,1,2,33,1,HK
tharimrattler,1486,3,1,2,33,1,NorCal Regionals
groceryoutletjustin,1486,3,1,2,33,1,NorCal Regionals
ddrsensation,1486,3,1,2,33,1,Combo Breaker
yk,1486,3,1,2,33,1,Ultra Hyakkishu Cup
dragon ninja,1486,3,1,2,33,1,SCR
kaynewesker,1486,3,1,2,33,1,NorCal Regionals
1atk.lxg.infrit,1486,3,1,2,33,1,SCR
mike cue,1486,3,1,2,33,1,CEO
lemoncrimes,1486,3,1,2,33,1,SCR
marcher29,1486,3,1,2,33,1,VS Fighting
onilink,1486,3,1,2,33,1,Combo Breaker
doctorstantz,1486,7,3,4,42,2,Combo Breaker;SCR
tay soul,1486,3,1,2,33,1,NorCal Regionals
millz,1486,3,1,2,33,1,NorCal Regionals
hadokenfieds,1486,3,1,2,33,1,Combo Breaker
ryan-san,1486,3,1,2,33,1,CEO
vsf|justinxavier,1486,3,1,2,33,1,Hypespotting
usfal|boony12,1486,3,1,2,33,1,VS Fighting
hf|tang,1486,3,1,2,33,1,NorCal Regionals
nefarious al,1486,3,1,2,33,1,NorCal Regionals
j fabulous,1486,3,1,2,33,1,Combo Breaker
s0n1c w0lf,1486,3,1,2,33,1,NorCal Regionals
sww|crumpets,1486,3,1,2,33,1,VS Fighting
ushijima,1486,3,1,2,33,1,Ultra Hyakkishu Cup
srm h0odless,1486,3,1,2,33,1,Combo Breaker
wl chris king,1486,3,1,2,33,1,SCR
narudo,1486,3,1,2,33,1,Ultra Hyakkishu Cup
李博 b春,1486,3,1,2,33,1,HK
oenomaus,1486,3,1,2,33,1,VS Fighting
reno,1486,3,1,2,33,1,SCR
codeserial,1486,3,1,2,33,1,NorCal Regionals
萧说说 萧说说,1486,3,1,2,33,1,CPTA Shanghai
paulkamezou,1486,3,1,2,33,1,SCR
onealsky,1486,3,1,2,33,1,CEO
gpl - tommy pickles,1486,3,1,2,33,1,NorCal Regionals
score,1486,3,1,2,33,1,Ultra Hyakkishu Cup
pigeon,1486,3,1,2,33,1,NorCal Regionals
吕尔德 八神,1486,3,1,2,33,1,CPTA Shanghai
lamune,1486,3,1,2,33,1,NorCal Regionals
rs|ko|kiki,1486,3,1,2,33,1,Hypespotting
wong chun yin denesis,1486,3,1,2,33,1,HK
2rawkets,1486,3,1,2,33,1,SCR
antman,1486,3,1,2,33,1,NorCal Regionals
du yong quan fslong,1486,3,1,2,33,1,HK
rs|simon “the truth” lau,1486,3,1,2,33,1,Hypespotting
mba|revenge,1486,3,1,2,33,1,VS Fighting
martin s,1486,3,1,2,33,1,SCR
sd_watt,1486,3,1,2,33,1,NorCal Regionals
fillossofherr,1486,3,1,2,33,1,SCR
t-venom,1486,3,1,2,33,1,NorCal Regionals
tm,1486,3,1,2,33,1,CEO
xft_fire xft_fire,1486,3,1,2,33,1,HK
belmont,1486,3,1,2,33,1,CEO
kb-zey,1486,3,1,2,33,1,VS Fighting
eggplant,1486,3,1,2,33,1,CEO
水 mizu,1486,3,1,2,33,1,Nine States
isaac chan panda,1486,3,1,2,33,1,HK
juniblaze xxx,1486,3,1,2,33,1,CEO
jaytag,1486,3,1,2,33,1,NorCal Regionals
shogun17,1486,3,1,2,33,1,Combo Breaker
mysticnamja,1486,3,1,2,33,1,SCR
sonny,1486,3,1,2,33,1,Milan Games Week
daft,1486,3,1,2,33,1,NorCal Regionals
blitzking109,1486,3,1,2,33,1,CEO
vs|hustle crowe,1486,3,1,2,33,1,VS Fighting
eruxiahou,1486,3,1,2,33,1,Hypespotting
屠双奇 t mug,1486,3,1,2,33,1,CPTA Shanghai
sir reginald,1486,3,1,2,33,1,NorCal Regionals
rde shiftingshadows,1486,3,1,2,33,1,Hypespotting
otaku strawberryball,1486,3,1,2,33,1,NorCal Regionals
donsanity,1486,3,1,2,33,1,SCR
thoth,1486,3,1,2,33,1,SCR
mba|yingah,1486,3,1,2,33,1,VS Fighting
m.a.d.e. gameover,1486,3,1,2,33,1,Combo Breaker
funplayer3s,1486,3,1,2,33,1,NorCal Regionals
lfgc maul,1486,3,1,2,33,1,Combo Breaker
e-town lord steezer,1486,3,1,2,33,1,Combo Breaker
shogundo,1486,3,1,2,33,1,Northwest Majors
david cameron.gov,1486,3,1,2,33,1,Hypespotting
天朝贵族,1486,3,1,2,33,1,Ze Fighting Game Champion
nfgc|moogle,1486,3,1,2,33,1,VS Fighting
remybleu,1486,2,0,2,0,1,Summer Jam
2002 pt cruiser,1486,3,1,2,33,1,CEO
ch (invitation pending),1486,3,1,2,33,1,Ze Fighting Game Champion
shinra,1486,3,1,2,33,1,CEO
laoshenjiang,1486,3,1,2,33,1,CPTA Shanghai
mba|spartan throne,1486,3,1,2,33,1,Hypespotting
collusion spark,1486,3,1,2,33,1,Northwest Majors
阿翰,1486,3,1,2,33,1,Ze Fighting Game Champion
crazed rice,1486,3,1,2,33,1,CEO
宅桑,1486,3,1,2,33,1,Ze Fighting Game Champion
aicalier,1486,3,1,2,33,1,CEO
samblack,1486,3,1,2,33,1,Northwest Majors
mba yingah,1486,3,1,2,33,1,Hypespotting
cpt.marvel,1486,3,1,2,33,1,Northwest Majors
mr.,1486,3,1,2,33,1,Northwest Majors
mto,1486,3,1,2,33,1,Combo Breaker
fsh,1486,3,1,2,33,1,Hypespotting
gailim,1486,3,1,2,33,1,CEO
ikatsui yarou,1486,2,0,2,0,1,Manila Cup
serpent,1486,3,1,2,33,1,Northwest Majors
gt tier3 wolf,1486,3,1,2,33,1,CEO
nigel lee,1486,3,1,2,33,1,FV Cup
masapiyo,1486,3,1,2,33,1,Northwest Majors
adan,1486,3,1,2,33,1,Milan Games Week
bushido,1486,3,1,2,33,1,Milan Games Week
taitsu,1486,3,1,2,33,1,FV Cup
conmystro,1486,3,1,2,33,1,CEO
matashoo,1486,3,1,2,33,1,Hypespotting
rde|wonder ham,1486,3,1,2,33,1,Hypespotting
suryan nair,1486,3,1,2,33,1,FV Cup
priestessos,1486,3,1,2,33,1,Hypespotting
reimalken,1486,3,1,2,33,1,Hypespotting
#bajaboys fullbleed,1486,7,3,4,42,2,Northwest Majors;Combo Breaker
ninjaspy,1486,3,1,2,33,1,Combo Breaker
ssquirtdirt,1486,3,1,2,33,1,CEO
fender,1486,3,1,2,33,1,CPTA KR
finchomatic,1486,3,1,2,33,1,Combo Breaker
itsforeverkursed,1486,2,0,2,0,1,CPTA KR
ilsenewton 19,1486,3,1,2,33,1,CPTA Shanghai
fibonacci,1486,3,1,2,33,1,Combo Breaker
beno,1486,3,1,2,33,1,Combo Breaker
r-18 hand holding,1486,3,1,2,33,1,First Attack
孙子隆 kimoji,1486,3,1,2,33,1,CPTA Shanghai
nexon,1486,3,1,2,33,1,First Attack
yousef84,1486,3,1,2,33,1,KO Fighting Game Festival
rgt murasaki,1486,3,1,2,33,1,Hypespotting
azrul,1486,3,1,2,33,1,FV Cup
章毅骏 屠jo奇,1486,3,1,2,33,1,HK
moduspwnens,1486,3,1,2,33,1,CEO
wtq8|bo bader,1486,3,1,2,33,1,KO Fighting Game Festival
zer0islife,1486,3,1,2,33,1,Combo Breaker
loseygosey,1486,3,1,2,33,1,CEO
gala tse dabugala,1486,3,1,2,33,1,HK
metal bender,1486,3,1,2,33,1,CEO
greateacher,1486,3,1,2,33,1,FV Cup
徐云龙 shinxcloud,1486,3,1,2,33,1,CPTA Shanghai
rey,1486,3,1,2,33,1,Combo Breaker
kmc hurricane,1486,3,1,2,33,1,CEO
dr rock,1486,3,1,2,33,1,FV Cup
bitta89,1486,3,1,2,33,1,Milan Games Week
blakrevolver,1486,3,1,2,33,1,Texas Showdown
bigboss dayasha,1486,3,1,2,33,1,CEO
pianodensetsu,1486,3,1,2,33,1,CEO
fullbring,1486,3,1,2,33,1,Texas Showdown
sacred,1486,3,1,2,33,1,Hypespotting
blue,1486,3,1,2,33,1,Taiwan
dojo_grandknight,1486,3,1,2,33,1,CEO
mohammad_,1486,3,1,2,33,1,KO Fighting Game Festival
s.i.r. straycrit,1486,3,1,2,33,1,Combo Breaker
rm9,1486,3,1,2,33,1,Taiwan
el maleman,1486,3,1,2,33,1,Texas Showdown
mikej,1486,3,1,2,33,1,CEO
fdf|loco shoto,1486,3,1,2,33,1,Texas Showdown
epyon,1486,3,1,2,33,1,Texas Showdown
孟澤,1486,3,1,2,33,1,Taiwan
fujiq8,1486,3,1,2,33,1,KO Fighting Game Festival
samuraispirit,1486,3,1,2,33,1,KO Fighting Game Festival
zack gademark mohadi,1486,3,1,2,33,1,CEO
kabukii,1486,3,1,2,33,1,Texas Showdown
flicky,1486,3,1,2,33,1,Hypespotting
epic|narcissistic,1486,3,1,2,33,1,Texas Showdown
loop|webtroy,1486,3,1,2,33,1,Texas Showdown
jamarvelous,1486,3,1,2,33,1,Combo Breaker
chen陳振銘,1486,3,1,2,33,1,Taiwan
sam malone,1486,3,1,2,33,1,Combo Breaker
duy,1486,3,1,2,33,1,Saigon Cup
jian hua,1486,3,1,2,33,1,Taiwan
joffocakes,1486,3,1,2,33,1,Hypespotting
島主,1486,3,1,2,33,1,Taiwan
rde|porcupine,1486,3,1,2,33,1,Hypespotting
ojg benjamin,1486,3,1,2,33,1,Combo Breaker
lee ho lun the killer,1486,3,1,2,33,1,HK
rjd,1486,3,1,2,33,1,CEO
482|jelly,1486,3,1,2,33,1,Texas Showdown
清哥,1486,3,1,2,33,1,Taiwan
morphtoxic,1486,3,1,2,33,1,CEO
tokles,1486,3,1,2,33,1,CEO
dylan campbell dcampb,1486,3,1,2,33,1,CPTA Shanghai
spencerjs,1486,3,1,2,33,1,Texas Showdown
jonnyslipsin,1486,3,1,2,33,1,Hypespotting
grubbs,1486,3,1,2,33,1,CEO
darealsteven,1486,3,1,2,33,1,Combo Breaker
fgr ts|murarob,1486,3,1,2,33,1,First Attack
elpr|tkd wolf,1486,3,1,2,33,1,First Attack
swk kaker,1486,3,1,2,33,1,Combo Breaker
kung_fru,1486,3,1,2,33,1,Texas Showdown
kenny kenny,1486,3,1,2,33,1,HK
hua0915,1486,3,1,2,33,1,Taiwan
小捷,1486,3,1,2,33,1,Taiwan
ang3lit0pr,1486,3,1,2,33,1,First Attack
itzspammy,1486,3,1,2,33,1,CEO
hii 5 ghost,1486,3,1,2,33,1,CEO
macto,1486,3,1,2,33,1,Texas Showdown
themanseries,1486,3,1,2,33,1,TFC
eltrouble,1486,3,1,2,33,1,Taiwan
nekoyuki,1486,3,1,2,33,1,CEO
phs slip n slide,1486,3,1,2,33,1,Texas Showdown
meo wei meo.w,1486,3,1,2,33,1,CPTA Shanghai
nwm lueshi,1486,3,1,2,33,1,CEO
みやこ,1486,3,1,2,33,1,Nine States
泰瑞鴿,1486,3,1,2,33,1,Taiwan
夏伟 minaさん,1486,3,1,2,33,1,CPTA Shanghai
ryutarou,1486,3,1,2,33,1,Ultra Hyakkishu Cup
msd xavi,1486,3,1,2,33,1,First Attack
gmd daydreamer,1486,3,1,2,33,1,Texas Showdown
ig|legendario drak,1486,3,1,2,33,1,First Attack
小鍾,1486,3,1,2,33,1,Taiwan
aimforthefeet,1486,3,1,2,33,1,TFC
soupbase,1486,3,1,2,33,1,Combo Breaker
dna,1486,3,1,2,33,1,Taiwan
hold dat l,1486,3,1,2,33,1,TFC
とまとたいがー,1486,3,1,2,33,1,Nine States
まいけるたん,1486,3,1,2,33,1,Nine States
eog rico,1486,3,1,2,33,1,TFC
millertime(usa),1486,3,1,2,33,1,Taiwan
マスタング,1486,3,1,2,33,1,Nine States
sasuke,1486,3,1,2,33,1,Taiwan
goodjazz,1486,3,1,2,33,1,CPTA Last Chance Qualifier
dr. atomic,1486,3,1,2,33,1,TFC
redninja,1486,3,1,2,33,1,TFC
马天健 ultrakiller,1486,3,1,2,33,1,CPTA Shanghai
silentnova,1486,3,1,2,33,1,TFC
theblackhombre,1486,3,1,2,33,1,CEO
ぢぢ@くろねこ,1486,3,1,2,33,1,Nine States
2iq|dangerous person,1486,3,1,2,33,1,Texas Showdown
ins dumbluck,1486,3,1,2,33,1,Texas Showdown
何文泉 中山泉仔,1486,3,1,2,33,1,HK
霧雨 kirisame,1486,3,1,2,33,1,Nine States
anthony bluesy,1486,3,1,2,33,1,HK
すけっち,1486,3,1,2,33,1,Nine States
saito,1486,3,1,2,33,1,First Attack
くりぱぱ kuripapa,1486,3,1,2,33,1,Nine States
wolfie,1486,3,1,2,33,1,Combo Breaker
vhs classics,1486,3,1,2,33,1,Combo Breaker
uli,1486,3,1,2,33,1,Combo Breaker
小龍包,1486,3,1,2,33,1,Taiwan
prk|razor,1486,3,1,2,33,1,First Attack
hectorputrid,1486,3,1,2,33,1,CEO
rgt crazy blk dude,1486,3,1,2,33,1,Combo Breaker
tony cha cha,1486,3,1,2,33,1,Taiwan
著名旅游玩家sky,1486,3,1,2,33,1,HK
shane,1486,3,1,2,33,1,CPTA Last Chance Qualifier
bigdamaul,1486,10,4,6,40,3,Nine States;NorCal Regionals;CPTA KR
wizlife69,1486,3,1,2,33,1,First Attack
よしかずさん。yoshikazu san,1486,3,1,2,33,1,Nine States
allenk,1486,3,1,2,33,1,Taiwan
睡大/sleeplong,1486,3,1,2,33,1,Taiwan
chibichild,1486,3,1,2,33,1,Combo Breaker
rpd mcz alex smith,1486,3,1,2,33,1,CEO
園長,1486,3,1,2,33,1,Taiwan
job mr. travis,1486,3,1,2,33,1,Combo Breaker
raxory.pr,1486,3,1,2,33,1,First Attack
jean,1486,3,1,2,33,1,Combo Breaker
spawn,1486,3,1,2,33,1,First Attack
bosco bosmoko,1486,3,1,2,33,1,HK
bryant chan bchan-hk47,1486,3,1,2,33,1,HK
sgc mwisk,1486,3,1,2,33,1,Combo Breaker
no name 0_o,1486,3,1,2,33,1,Combo Breaker
bcw greyskarr,1485,2,0,2,0,1,TFC
electribe,1485,2,0,2,0,1,Ultra Hyakkishu Cup
top hat,1485,3,1,2,33,1,Combo Breaker
mba|armdevil,1485,7,3,4,42,2,Hypespotting;VS Fighting
mast,1485,2,0,2,0,1,Ultra Hyakkishu Cup
remes,1485,10,3,7,30,1,Dreamhack Summer
jd,1485,7,3,4,42,2,VS Fighting;CPTA Last Chance Qualifier
章毅骏 阿骏,1485,3,1,2,33,1,CPTA Shanghai
kuraudo,1485,3,1,2,33,1,TFC
pag celestine,1485,3,1,2,33,1,CEO
xft jin tai xft jin tai,1485,3,1,2,33,1,HK
jns,1485,9,3,6,33,2,Dreamhack Summer;Dreamhack Winter
daniel dillips,1485,7,3,4,42,2,VS Fighting;EGX
starkillershane,1485,3,1,2,33,1,VS Fighting
exg rosiechan92,1485,3,1,2,33,1,CEO
shakugan,1485,3,1,2,33,1,SCR
soulless,1485,3,1,2,33,1,SCR
battery pack,1485,3,1,2,33,1,SCR
winhow.jung,1485,3,1,2,33,1,Taiwan
pandorascrate,1485,3,1,2,33,1,SCR
jun-ichi11,1485,5,2,3,40,1,CEO
hikarin,1484,2,0,2,0,1,Nine States
pragmag,1484,3,1,2,33,1,SCR
oni.,1484,2,0,2,0,1,Ultra Hyakkishu Cup
lyhs,1484,8,3,5,37,1,Dreamhack Summer
domo,1484,6,2,4,33,1,CPTA Last Chance Qualifier
papz,1484,6,2,4,33,1,Dreamhack Summer
vt mgt,1484,2,0,2,0,1,Red Fight District
gingerv1k1ng,1484,4,1,3,25,1,Dreamhack Winter
the leoholic,1484,2,0,2,0,1,Red Fight District
ホルト horuto,1483,2,0,2,0,1,Nine States
asimulation,1483,2,0,2,0,1,NorCal Regionals
usami mushiko,1483,2,0,2,0,1,Ultra Hyakkishu Cup
ddungemi43,1483,2,0,2,0,1,CPTA KR
tsm|leffen,1483,2,0,2,0,1,Call of Ragnarok
b0tes,1483,2,0,2,0,1,Combo Breaker
mx mad,1483,2,0,2,0,1,TFC
cuddles,1483,2,0,2,0,1,CEO
john a falcon,1483,2,0,2,0,1,TFC
flex in the city,1483,2,0,2,0,1,CEO
itsbrianlol,1483,2,0,2,0,1,SCR
itsther,1483,2,0,2,0,1,TFC
sd|feist,1483,2,0,2,0,1,SCR
themulverine,1483,2,0,2,0,1,CPTA KR
138zod,1483,2,0,2,0,1,NorCal Regionals
陈冕 福州|史莱姆,1483,2,0,2,0,1,CPTA Shanghai
ngamer3k,1483,6,2,4,33,2,NorCal Regionals;Combo Breaker
drakefang,1482,2,0,2,0,1,CPTA KR
lexu,1482,2,0,2,0,1,Hypespotting
space problems,1482,2,0,2,0,1,Hypespotting
applemouse,1482,2,0,2,0,1,Taiwan
ぷりん,1482,2,0,2,0,1,KSB 2015
まーやー,1482,2,0,2,0,1,KSB 2015
scc|lark0,1482,6,2,4,33,2,Hypespotting;VS Fighting
sww|phoenix,1482,6,2,4,33,2,Hypespotting;VS Fighting
lior,1482,2,0,2,0,1,Cannes Winter Clash
remonadonoghue3,1482,2,0,2,0,1,Ze Fighting Game Champion
streetmonkeys gotthemojo,1482,2,0,2,0,1,Red Fight District
yuosham,1482,2,0,2,0,1,KO Fighting Game Festival
kobra,1482,4,1,3,25,1,Dreamhack Winter
flb azizul,1482,2,0,2,0,1,EGX
shiro(xiao bai),1482,2,0,2,0,1,CPTA KR
team.veggey bliredd,1482,8,3,5,37,1,Dreamhack Summer
robbie q,1482,2,0,2,0,1,Hypespotting
pompom,1481,2,0,2,0,1,Taiwan
mr.magiclove,1481,4,1,3,25,1,Dreamhack Winter
rd/mr.karate,1481,2,0,2,0,1,Northwest Majors
badi lootion,1481,2,0,2,0,1,Call of Ragnarok
robert dunne saor,1481,2,0,2,0,1,HK
鍾竹軒/hsuan,1481,2,0,2,0,1,Taiwan
heidibardon,1481,2,0,2,0,1,Ze Fighting Game Champion
initial kyouso,1481,2,0,2,0,1,Ultra Hyakkishu Cup
hf|inorite,1481,2,0,2,0,1,NorCal Regionals
peatdefeat,1481,4,1,3,25,1,Dreamhack Winter
tal,1481,6,2,4,33,2,CEO;TFC
hame na geru shogun,1481,2,0,2,0,1,Ultra Hyakkishu Cup
akg jedisalazar,1481,2,0,2,0,1,SCR
ww|camizakof,1481,2,0,2,0,1,CPT Brazil
べー,1481,2,0,2,0,1,KSB 2015
vidacarstensen,1481,2,0,2,0,1,Ze Fighting Game Champion
ギャズ,1481,2,0,2,0,1,KSB 2015
xxstealthsneakxx,1481,4,1,3,25,1,CEO
島唄,1481,2,0,2,0,1,KSB 2015
chris gillon,1481,2,0,2,0,1,Hypespotting
zemerick,1481,2,0,2,0,1,Ze Fighting Game Champion
杰克逊,1481,2,0,2,0,1,Ze Fighting Game Champion
vsl sizzla971,1481,2,0,2,0,1,Ze Fighting Game Champion
石頭,1481,2,0,2,0,1,Taiwan
lieselottetietje,1481,2,0,2,0,1,Ze Fighting Game Champion
dragonglove,1480,2,0,2,0,1,Northwest Majors
ちーたん,1480,6,2,4,33,1,Nine States
dreadleif,1480,7,2,5,28,1,Dreamhack Summer
teddy xft_teddybear,1480,2,0,2,0,1,HK
jigsaw,1480,2,0,2,0,1,NorCal Regionals
jeppa~,1480,6,2,4,33,2,KSB 2015;Ultra Hyakkishu Cup
dmt loki kky,1480,2,0,2,0,1,SCR
jonathan swee,1480,2,0,2,0,1,FV Cup
zeusx,1480,2,0,2,0,1,KO Fighting Game Festival
sanjo,1480,2,0,2,0,1,KSB 2015
eunbeen,1480,2,0,2,0,1,Call of Ragnarok
warbio,1480,17,6,11,35,3,Dreamhack Summer;Red Fight District;Dreamhack Winter
mathlete,1480,2,0,2,0,1,NorCal Regionals
namcore,1480,4,1,3,25,1,Dreamhack Winter
raj obee,1480,2,0,2,0,1,Summer Jam
snow cone,1480,2,0,2,0,1,NorCal Regionals
moto,1480,2,0,2,0,1,Ultra Hyakkishu Cup
cfc|joão jotão,1480,4,1,3,25,1,Dreamhack Winter
mob slim,1480,2,0,2,0,1,Summer Jam
vgftaylor,1480,2,0,2,0,1,Northwest Majors
ilovepjw,1480,2,0,2,0,1,CPTA KR
accurate,1480,2,0,2,0,1,NorCal Regionals
zenny,1480,2,0,2,0,1,Ultra Hyakkishu Cup
mizoguchi akikimi,1480,2,0,2,0,1,Ultra Hyakkishu Cup
bklynexpress,1480,12,5,7,41,3,Northwest Majors;CEO;SCR
dav0s,1480,2,0,2,0,1,CPTA KR
kerick,1480,2,0,2,0,1,Taiwan
vsf justin,1480,2,0,2,0,1,EGX
ex2 roy munson,1480,2,0,2,0,1,Hypespotting
shazli,1480,2,0,2,0,1,FV Cup
kendofox,1480,2,0,2,0,1,Taiwan
unggul,1480,2,0,2,0,1,Abuget Cup
sean-go,1480,2,0,2,0,1,NorCal Regionals
wong wai tak steve wong,1480,4,1,3,25,1,HK
hootington,1480,2,0,2,0,1,Northwest Majors
pedro unchained,1480,7,2,5,28,1,Dreamhack Summer
marcoflight,1479,2,0,2,0,1,Milan Games Week
hagen,1479,2,0,2,0,1,Hypespotting
snaketits,1479,2,0,2,0,1,SCR
artemis,1479,2,0,2,0,1,Northwest Majors
junkohawley 19,1479,2,0,2,0,1,CPTA Shanghai
lemon pie,1479,2,0,2,0,1,SCR
unclesatan,1479,2,0,2,0,1,Northwest Majors
juantonimobay,1479,2,0,2,0,1,NorCal Regionals
visual badmuts24,1479,2,0,2,0,1,Red Fight District
sinical,1479,2,0,2,0,1,Red Fight District
sfo|tscooler,1479,2,0,2,0,1,Hypespotting
林帆 lingfan500,1479,2,0,2,0,1,CPTA Shanghai
the3rdchild,1479,2,0,2,0,1,Hypespotting
doc,1479,2,0,2,0,1,Northwest Majors
scar,1479,2,0,2,0,1,NorCal Regionals
thunderlips,1479,2,0,2,0,1,Hypespotting
senseisoul,1479,2,0,2,0,1,Hypespotting
hanamaruki,1479,2,0,2,0,1,Ultra Hyakkishu Cup
金デヴ,1479,2,0,2,0,1,KSB 2015
vs tss paladin,1479,2,0,2,0,1,Hypespotting
chanson,1479,2,0,2,0,1,Ultra Hyakkishu Cup
kenmike,1479,2,0,2,0,1,Abuget Cup
skunk,1479,2,0,2,0,1,Ultra Hyakkishu Cup
beastbamba,1479,2,0,2,0,1,NorCal Regionals
194 pedro,1479,4,1,3,25,1,Dreamhack Winter
iahadima,1479,5,1,4,20,1,Dreamhack Summer
dion,1479,2,0,2,0,1,Abuget Cup
flat,1479,2,0,2,0,1,Ultra Hyakkishu Cup
madvillain,1479,2,0,2,0,1,Hypespotting
gameguys nero,1479,2,0,2,0,1,Texas Showdown
jafar,1479,2,0,2,0,1,FV Cup
hells w1nd,1479,2,0,2,0,1,EGX
meisai ningyo,1479,2,0,2,0,1,Ultra Hyakkishu Cup
unsu,1479,2,0,2,0,1,Ultra Hyakkishu Cup
badguy,1479,2,0,2,0,1,Northwest Majors
a4|andre,1479,2,0,2,0,1,Hypespotting
gilky,1479,2,0,2,0,1,Combo Breaker
gearbox63,1479,2,0,2,0,1,NorCal Regionals
pain,1479,2,0,2,0,1,KO Fighting Game Festival
macfaltine,1479,2,0,2,0,1,NorCal Regionals
og|lil evil,1479,6,2,4,33,2,CEO;Defend the North
newbtrait,1479,2,0,2,0,1,NorCal Regionals
モッツェルおじさん,1479,2,0,2,0,1,KSB 2015
カリスマ,1479,2,0,2,0,1,KSB 2015
neogaf shackzam,1479,2,0,2,0,1,Combo Breaker
derick s,1479,2,0,2,0,1,Northwest Majors
bk9999,1479,2,0,2,0,1,CPTA Last Chance Qualifier
jiraiya kurokaze,1479,2,0,2,0,1,Combo Breaker
joe young,1479,2,0,2,0,1,Northwest Majors
mrbungle,1478,6,2,4,33,2,Hypespotting;VS Fighting
mr wolf,1478,2,0,2,0,1,Milan Games Week
めりっぷ,1478,6,2,4,33,1,Nine States
shonk,1478,4,1,3,25,1,Dreamhack Winter
satc1014,1478,2,0,2,0,1,Taiwan
citizen,1478,2,0,2,0,1,EGX
japf,1478,4,1,3,25,1,Dreamhack Winter
l.grinta,1477,6,2,4,33,2,NorCal Regionals;SCR
f99|driftwood,1477,5,1,4,20,3,Final Round;EVO;SCR
matune,1476,2,0,2,0,1,CPTA KR
rese|goldenbiscuit,1476,2,0,2,0,1,TFC
たいがー,1476,2,0,2,0,1,KSB 2015
rocketsmith,1476,2,0,2,0,1,CEO
choi chak choi chak gs base 10/hr,1476,2,0,2,0,1,HK
agoat,1476,2,0,2,0,1,CEO
rm kites,1476,2,0,2,0,1,CEO
niceblock skenming,1476,6,2,4,33,1,HK
hame-tamu,1476,2,0,2,0,1,Ultra Hyakkishu Cup
freddie m.,1476,2,0,2,0,1,CEO
s̶c̶u̶b̶a̶s̶t̶e̶v̶e̶2̶5̶3̶ ̶-̶ ̶w,1476,2,0,2,0,1,Northwest Majors
slappytheninja,1476,2,0,2,0,1,Northwest Majors
ivanpants,1476,4,1,3,25,1,Texas Showdown
bobcustomgamer,1476,2,0,2,0,1,CEO
kinetic semiij,1476,2,0,2,0,1,CEO
clxjames,1476,2,0,2,0,1,CEO
jed,1476,2,0,2,0,1,SCR
styxtbm,1475,2,0,2,0,1,Texas Showdown
agi.rsd.charmingrogue,1475,5,1,4,20,1,Dreamhack Summer
tss brother joshua,1475,2,0,2,0,1,Texas Showdown
lilloco562,1475,2,0,2,0,1,SCR
urbanexpression,1475,2,0,2,0,1,SCR
tof,1475,2,0,2,0,1,SCR
gungnir,1475,2,0,2,0,1,TFC
plats,1475,2,0,2,0,1,VS Fighting
gatoradmiral,1475,2,0,2,0,1,SCR
silent hero,1475,2,0,2,0,1,TFC
sbh|intehweeds,1475,2,0,2,0,1,CEO
ottokbron,1475,2,0,2,0,1,SCR
frogboat,1475,2,0,2,0,1,CEO
r-gonaut,1475,2,0,2,0,1,SCR
ut mr gork,1475,2,0,2,0,1,CEO
butts mckenzie,1475,2,0,2,0,1,CEO
lf|luoji - fenru,1475,2,0,2,0,1,NorCal Regionals
caderax,1475,2,0,2,0,1,NorCal Regionals
kit sbk,1475,2,0,2,0,1,SCR
s-blade,1475,2,0,2,0,1,Northwest Majors
holding,1475,2,0,2,0,1,SCR
c. chavez,1475,2,0,2,0,1,SCR
skarfelt,1475,2,0,2,0,1,VS Fighting
metaldb,1475,2,0,2,0,1,First Attack
urban shakedown,1475,2,0,2,0,1,SCR
jeebius,1475,2,0,2,0,1,VS Fighting
pewchee,1475,2,0,2,0,1,CEO
waffle slapper,1475,2,0,2,0,1,SCR
happyton,1475,2,0,2,0,1,VS Fighting
jctustin,1475,2,0,2,0,1,SCR
near,1475,2,0,2,0,1,VS Fighting
kenneth,1475,2,0,2,0,1,FV Cup
30f|nagai,1475,2,0,2,0,1,Northwest Majors
yeison,1475,2,0,2,0,1,First Attack
black2dafuturez,1475,2,0,2,0,1,VS Fighting
oc,1475,2,0,2,0,1,Ze Fighting Game Champion
grasshoppa,1475,2,0,2,0,1,Combo Breaker
bluebomber,1475,2,0,2,0,1,NorCal Regionals
guro_loli,1475,2,0,2,0,1,Northwest Majors
goku,1475,2,0,2,0,1,First Attack
bon weiu,1475,2,0,2,0,1,FV Cup
joel bowl,1475,2,0,2,0,1,Hypespotting
pmp revostylez,1475,2,0,2,0,1,First Attack
thariddler,1475,2,0,2,0,1,CEO
dianpao,1475,2,0,2,0,1,CPTA Shanghai
pureevilj,1475,2,0,2,0,1,Combo Breaker
vexatiousidler,1475,2,0,2,0,1,Hypespotting
emmcub3d,1475,2,0,2,0,1,CEO
1260-tan,1475,2,0,2,0,1,Ultra Hyakkishu Cup
ganz_76,1475,2,0,2,0,1,Milan Games Week
zeal,1475,2,0,2,0,1,FV Cup
lord lorenz,1475,2,0,2,0,1,Milan Games Week
pattheflip,1475,2,0,2,0,1,CEO
obake,1475,2,0,2,0,1,Red Fight District
gentle cam,1475,2,0,2,0,1,CEO
hawt salsa,1475,2,0,2,0,1,Northwest Majors
benteezy,1475,2,0,2,0,1,CEO
蔡钦 烈火麦当劳,1475,2,0,2,0,1,CPTA Shanghai
rm narwhal,1475,2,0,2,0,1,CEO
prdrakwolf,1475,2,0,2,0,1,First Attack
古奇 古奇,1475,2,0,2,0,1,CPTA Shanghai
zutroi,1475,2,0,2,0,1,Milan Games Week
troja,1475,2,0,2,0,1,Texas Showdown
gi_vantinel,1475,2,0,2,0,1,CEO
solda,1475,2,0,2,0,1,Milan Games Week
jtd,1475,2,0,2,0,1,Texas Showdown
fv edwin,1475,2,0,2,0,1,FV Cup
vsf jinty,1475,2,0,2,0,1,EGX
lorenzo pieracci,1475,2,0,2,0,1,Milan Games Week
nicoy tiengo,1475,2,0,2,0,1,Milan Games Week
usps mailmanimp,1475,2,0,2,0,1,Texas Showdown
berri,1475,2,0,2,0,1,Milan Games Week
pan,1475,2,0,2,0,1,Milan Games Week
mdzor,1475,2,0,2,0,1,Saigon Cup
nico,1475,2,0,2,0,1,Milan Games Week
dgskater,1475,2,0,2,0,1,CEO
sater_s1,1475,2,0,2,0,1,Milan Games Week
dllinftl,1475,2,0,2,0,1,CEO
bfl|mowatman,1475,6,2,4,33,2,Hypespotting;VS Fighting
alex yang,1475,2,0,2,0,1,CPTA Last Chance Qualifier
rocketgruntmark,1475,2,0,2,0,1,Texas Showdown
merlock,1475,2,0,2,0,1,Combo Breaker
springwood slasher,1475,2,0,2,0,1,Combo Breaker
陆祁仁 johnny,1475,2,0,2,0,1,CPTA Shanghai
spg squalayyy,1475,2,0,2,0,1,CEO
second_son_5ald,1475,2,0,2,0,1,KO Fighting Game Festival
other scott,1475,2,0,2,0,1,CEO
brandon,1475,2,0,2,0,1,Nine States
me shane,1475,2,0,2,0,1,CPTA Last Chance Qualifier
お花畑,1475,2,0,2,0,1,Nine States
えにてょ,1475,2,0,2,0,1,Nine States
陈智聪 坑头仔,1475,2,0,2,0,1,HK
rbr|ecchi mane,1475,2,0,2,0,1,Texas Showdown
abodora,1475,2,0,2,0,1,KO Fighting Game Festival
hnh rs huggybear,1475,2,0,2,0,1,CEO
uptempo87,1475,2,0,2,0,1,CEO
benji v.,1475,2,0,2,0,1,CEO
talal eg,1475,2,0,2,0,1,KO Fighting Game Festival
7ussein_alsalmam,1475,2,0,2,0,1,KO Fighting Game Festival
batman,1475,2,0,2,0,1,Texas Showdown
alex-23,1475,2,0,2,0,1,Texas Showdown
bader almahmeed,1475,2,0,2,0,1,KO Fighting Game Festival
hotsoup,1475,2,0,2,0,1,Combo Breaker
mr traumallama,1475,2,0,2,0,1,CEO
avernaus,1475,2,0,2,0,1,KO Fighting Game Festival
berzack,1474,2,0,2,0,1,True Challengers Costa Rica
kaiweiwong homer0708,1474,2,0,2,0,1,HK
swoopcoupe,1474,2,0,2,0,1,Texas Showdown
hamad_ahli,1474,2,0,2,0,1,KO Fighting Game Festival
king koopa,1474,6,2,4,33,2,Texas Showdown;CEO
ali_ahli,1474,2,0,2,0,1,KO Fighting Game Festival
the american dream,1474,2,0,2,0,1,Texas Showdown
wtq8|ibraheem,1474,2,0,2,0,1,KO Fighting Game Festival
liquid chillin,1474,2,0,2,0,1,CEO
yanyan(japan),1474,2,0,2,0,1,Taiwan
shadowofmath,1474,2,0,2,0,1,KO Fighting Game Festival
ao3,1474,2,0,2,0,1,FV Cup
fickle platypus,1474,2,0,2,0,1,Texas Showdown
ins aj tucker,1474,2,0,2,0,1,Texas Showdown
leafyboy12,1474,2,0,2,0,1,CEO
demitri,1474,2,0,2,0,1,Texas Showdown
kayto_aa,1474,2,0,2,0,1,KO Fighting Game Festival
three6d,1474,2,0,2,0,1,Texas Showdown
sm gill,1474,2,0,2,0,1,Texas Showdown
shahril harith,1474,2,0,2,0,1,FV Cup
down right fierce,1474,2,0,2,0,1,CEO
vinness ho,1474,2,0,2,0,1,FV Cup
fake hd,1474,2,0,2,0,1,Taiwan
jacopdr,1474,2,0,2,0,1,KO Fighting Game Festival
iyokuu,1474,2,0,2,0,1,Texas Showdown
nick rb,1474,2,0,2,0,1,Texas Showdown
failakawi,1474,2,0,2,0,1,KO Fighting Game Festival
bo_aseel,1474,2,0,2,0,1,KO Fighting Game Festival
lupasan,1474,2,0,2,0,1,CEO
あかり,1474,2,0,2,0,1,KSB 2015
osama_kun,1474,2,0,2,0,1,KO Fighting Game Festival
cecil,1474,2,0,2,0,1,Texas Showdown
ミゾテル,1474,2,0,2,0,1,KSB 2015
mortal_comebax,1474,2,0,2,0,1,KO Fighting Game Festival
reco,1474,2,0,2,0,1,Taiwan
q8tyloco,1474,2,0,2,0,1,KO Fighting Game Festival
mio bison,1474,2,0,2,0,1,CEO
svr ascender,1474,2,0,2,0,1,CEO
様式美,1474,2,0,2,0,1,KSB 2015
fv sangbubu,1474,2,0,2,0,1,FV Cup
餃子,1474,2,0,2,0,1,Taiwan
faisalalmutairi,1474,2,0,2,0,1,KO Fighting Game Festival
mba spartan throne,1474,2,0,2,0,1,EGX
botb mr.v,1474,2,0,2,0,1,Texas Showdown
pag vgcj maestro,1474,2,0,2,0,1,CEO
da doomsday,1474,2,0,2,0,1,Texas Showdown
metalqueersolid,1474,2,0,2,0,1,EGX
內子宮崎葵,1474,2,0,2,0,1,Taiwan
kec|sl burnout,1474,2,0,2,0,1,CPTA KR
dry captain ook,1474,2,0,2,0,1,EGX
aldy,1474,2,0,2,0,1,Abuget Cup
adil g,1474,2,0,2,0,1,CEO
koifishing,1474,2,0,2,0,1,Texas Showdown
spiritzero,1474,2,0,2,0,1,CPTA KR
ss king jae,1474,2,0,2,0,1,EGX
babycakes,1474,2,0,2,0,1,CEO
sennette,1474,2,0,2,0,1,Saigon Cup
steve791,1474,2,0,2,0,1,CPTA KR
julian13,1474,2,0,2,0,1,Combo Breaker
gaumin,1474,2,0,2,0,1,Saigon Cup
jebus,1474,2,0,2,0,1,Texas Showdown
ferny,1474,2,0,2,0,1,CEO
gg|alioufe,1474,2,0,2,0,1,Saigon Cup
legato974,1474,2,0,2,0,1,CPTA KR
terry kok,1474,2,0,2,0,1,FV Cup
feedthehead,1474,2,0,2,0,1,CEO
aiku,1474,2,0,2,0,1,CPTA KR
jackiechanningtatum,1474,2,0,2,0,1,Saigon Cup
tomjw88,1474,2,0,2,0,1,CEO
'daitarn 3,1474,2,0,2,0,1,CEO
srkuw|future trunks,1474,2,0,2,0,1,Northwest Majors
娃娃,1474,2,0,2,0,1,Taiwan
quang,1474,2,0,2,0,1,Saigon Cup
takuyasugi,1474,2,0,2,0,1,Texas Showdown
rut jabikuta,1474,2,0,2,0,1,CEO
ta|agent ecks,1474,2,0,2,0,1,Texas Showdown
duc nguyen,1474,2,0,2,0,1,Saigon Cup
fems,1474,2,0,2,0,1,CEO
welcome to you're doom!,1474,2,0,2,0,1,Northwest Majors
kilink/kk,1474,2,0,2,0,1,Taiwan
xmen007(hong kong),1474,2,0,2,0,1,Taiwan
tam,1474,2,0,2,0,1,Saigon Cup
2iq|mothman,1474,2,0,2,0,1,Texas Showdown
man filth,1474,2,0,2,0,1,Red Fight District
dmv makoto,1474,2,0,2,0,1,CEO
hom philocypher,1474,2,0,2,0,1,Combo Breaker
nopo shrub treks,1474,4,1,3,25,1,CEO
ohdomai,1474,2,0,2,0,1,Taiwan
exg convictedoffun,1474,2,0,2,0,1,CEO
pote,1474,2,0,2,0,1,Northwest Majors
vt kirat,1474,2,0,2,0,1,Red Fight District
asnakeasolid,1474,2,0,2,0,1,CEO
renzuo,1474,2,0,2,0,1,FV Cup
u_no_hoo,1474,2,0,2,0,1,CEO
feo grande,1474,2,0,2,0,1,CEO
ake nupa,1474,2,0,2,0,1,Northwest Majors
anbu arisato,1474,2,0,2,0,1,CEO
mdz kampfkeks667,1474,2,0,2,0,1,Red Fight District
c88_tbn daymein,1474,2,0,2,0,1,Texas Showdown
niceguyngo,1474,2,0,2,0,1,Northwest Majors
吉米,1474,2,0,2,0,1,Taiwan
setx|[kf] @iwasblocking,1474,2,0,2,0,1,Texas Showdown
jackson deruloo,1474,2,0,2,0,1,Northwest Majors
reco子親愛的,1474,2,0,2,0,1,Taiwan
arkanis,1474,2,0,2,0,1,Texas Showdown
anotheryou,1474,2,0,2,0,1,FV Cup
hashshashiyyin,1474,2,0,2,0,1,Red Fight District
papa giasso,1474,2,0,2,0,1,TFC
tata chan tata,1474,2,0,2,0,1,HK
keth,1474,2,0,2,0,1,CEO
moddren-l fuego,1474,2,0,2,0,1,Texas Showdown
spenttime,1474,2,0,2,0,1,Northwest Majors
simplyktg,1474,2,0,2,0,1,CEO
格雷特,1474,2,0,2,0,1,Taiwan
aski,1474,2,0,2,0,1,Taiwan
dikdik,1474,2,0,2,0,1,FV Cup
ucc|mattikus,1474,2,0,2,0,1,Texas Showdown
豆奶,1474,2,0,2,0,1,Ze Fighting Game Champion
[kf] mdrm,1474,2,0,2,0,1,Texas Showdown
kevin munoz,1474,2,0,2,0,1,TFC
罗国樑 robert仔,1474,2,0,2,0,1,HK
moist,1474,2,0,2,0,1,Northwest Majors
ua|mrhoward123,1474,2,0,2,0,1,Texas Showdown
ok-gandy,1474,2,0,2,0,1,CEO
mclovin,1474,2,0,2,0,1,TFC
angry black,1474,2,0,2,0,1,Combo Breaker
christian,1474,2,0,2,0,1,Ze Fighting Game Champion
sman,1474,2,0,2,0,1,Taiwan
jesse munoz,1474,2,0,2,0,1,TFC
mrxrubin,1474,2,0,2,0,1,Northwest Majors
py,1474,2,0,2,0,1,Ze Fighting Game Champion
jesse hamilton,1474,2,0,2,0,1,TFC
765pro,1474,2,0,2,0,1,Northwest Majors
tom b,1474,2,0,2,0,1,VS Fighting
hedgiex,1474,2,0,2,0,1,CEO
mehdi,1474,2,0,2,0,1,Ze Fighting Game Champion
yopumpkinhead,1474,2,0,2,0,1,Northwest Majors
紫月,1474,2,0,2,0,1,Ze Fighting Game Champion
30f|teyah,1474,2,0,2,0,1,Northwest Majors
el-psy,1474,2,0,2,0,1,CEO
手把老桑,1474,2,0,2,0,1,Taiwan
smbf|oxidopamine,1474,2,0,2,0,1,VS Fighting
kylexxpro,1474,2,0,2,0,1,VS Fighting
ジュリカス jurikasu,1474,2,0,2,0,1,Nine States
l4,1474,2,0,2,0,1,TFC
tuan,1474,2,0,2,0,1,Northwest Majors
cxhwang,1474,2,0,2,0,1,Northwest Majors
indmou,1474,2,0,2,0,1,Ze Fighting Game Champion
dkn29,1474,2,0,2,0,1,Northwest Majors
souler,1474,2,0,2,0,1,Ze Fighting Game Champion
teaseeoh,1474,2,0,2,0,1,CEO
rain,1474,2,0,2,0,1,Northwest Majors
reuben,1474,2,0,2,0,1,VS Fighting
xiao_zhu(france),1474,2,0,2,0,1,Taiwan
the demonofmist,1474,2,0,2,0,1,CEO
fatdog,1474,2,0,2,0,1,Ze Fighting Game Champion
peterson,1474,2,0,2,0,1,CEO
vetash32,1474,2,0,2,0,1,Taiwan
のび太,1474,2,0,2,0,1,Nine States
calmspaghetti,1474,2,0,2,0,1,NorCal Regionals
ds|rythla,1474,2,0,2,0,1,VS Fighting
kaptain,1474,2,0,2,0,1,VS Fighting
beamsprouts,1474,2,0,2,0,1,NorCal Regionals
graystump,1474,2,0,2,0,1,NorCal Regionals
geronimo,1474,2,0,2,0,1,SCR
twiggyflacko,1474,2,0,2,0,1,CEO
reiji,1474,2,0,2,0,1,TFC
chibz,1474,2,0,2,0,1,NorCal Regionals
setx|hd,1474,2,0,2,0,1,Texas Showdown
rocksteady,1474,2,0,2,0,1,SCR
tombstone,1474,2,0,2,0,1,TFC
shindoru,1474,2,0,2,0,1,VS Fighting
ex,1474,6,2,4,33,2,NorCal Regionals;CEO
geenoh,1474,2,0,2,0,1,SCR
bcw big tone,1474,2,0,2,0,1,CEO
retro glacius,1474,2,0,2,0,1,SCR
偉智/wedi,1474,2,0,2,0,1,Taiwan
legendarygamer,1474,2,0,2,0,1,SCR
mrgrreatness,1474,2,0,2,0,1,CEO
tony tyrant,1474,2,0,2,0,1,HK
nb elithecurry,1474,2,0,2,0,1,CEO
baker,1474,2,0,2,0,1,SCR
dwe|mcbae,1474,2,0,2,0,1,TFC
wrongonred,1474,2,0,2,0,1,CEO
silverhydra,1474,2,0,2,0,1,Combo Breaker
髭とボイン hige to boin,1474,2,0,2,0,1,Nine States
maes alexis hittheplane,1474,2,0,2,0,1,HK
señor goggles,1474,2,0,2,0,1,SCR
barrazie,1474,2,0,2,0,1,NorCal Regionals
b&b mm_food,1474,2,0,2,0,1,Combo Breaker
schmidt,1474,2,0,2,0,1,CEO
chase,1474,2,0,2,0,1,SCR
eliver ling,1474,2,0,2,0,1,NorCal Regionals
bfl|mr stabbie,1474,2,0,2,0,1,VS Fighting
hke|toyz(hong kong),1474,2,0,2,0,1,Taiwan
j.baysik,1474,2,0,2,0,1,NorCal Regionals
stepmasterryan,1474,2,0,2,0,1,SCR
professor beef,1474,2,0,2,0,1,NorCal Regionals
lee ka ho ys,1474,2,0,2,0,1,HK
rst sinful,1474,2,0,2,0,1,CEO
derek magee,1474,2,0,2,0,1,SCR
954_doza,1474,2,0,2,0,1,CEO
iebg dreammerchant,1474,2,0,2,0,1,SCR
anbu bpoilspill,1474,2,0,2,0,1,TFC
setx spurs21,1474,2,0,2,0,1,Texas Showdown
r.mitake,1474,2,0,2,0,1,Nine States
max'd out,1474,2,0,2,0,1,TFC
ed|neodurge,1474,2,0,2,0,1,VS Fighting
ph emberandroses,1474,2,0,2,0,1,SCR
meatyfp,1474,2,0,2,0,1,CEO
mr.e,1474,2,0,2,0,1,VS Fighting
rhinostarr,1474,2,0,2,0,1,VS Fighting
noctis_786,1474,2,0,2,0,1,VS Fighting
shing07,1474,2,0,2,0,1,NorCal Regionals
ryer,1474,2,0,2,0,1,CEO
havecontrollerwilltravel,1474,2,0,2,0,1,Combo Breaker
nz|notinal,1474,2,0,2,0,1,NorCal Regionals
biscuitpinoy,1474,2,0,2,0,1,NorCal Regionals
これ!どれ?アレ!ん kore!dore? are! n,1474,2,0,2,0,1,Nine States
idiocy,1474,2,0,2,0,1,NorCal Regionals
doons,1474,2,0,2,0,1,NorCal Regionals
チキチキン,1474,2,0,2,0,1,Nine States
pinecone,1474,2,0,2,0,1,SCR
marquezsf,1474,2,0,2,0,1,NorCal Regionals
irep shadz,1474,2,0,2,0,1,VS Fighting
beast mode,1474,2,0,2,0,1,Texas Showdown
jt,1474,2,0,2,0,1,NorCal Regionals
setx|tyler (yo.),1474,2,0,2,0,1,Texas Showdown
phantom miria,1474,2,0,2,0,1,NorCal Regionals
pmoney,1474,2,0,2,0,1,SCR
ds|pak_mei,1474,2,0,2,0,1,VS Fighting
flex negative,1474,2,0,2,0,1,TFC
highlevelnovice,1474,2,0,2,0,1,TFC
ed|big man baird,1474,2,0,2,0,1,VS Fighting
rudetuna,1474,2,0,2,0,1,Combo Breaker
virus,1474,2,0,2,0,1,NorCal Regionals
bloodmasterlink,1474,2,0,2,0,1,CEO
guitar7s,1474,2,0,2,0,1,CEO
ssrcg|van slab,1474,2,0,2,0,1,VS Fighting
hibiki,1474,2,0,2,0,1,Texas Showdown
fadcant pr,1474,2,0,2,0,1,First Attack
set,1474,2,0,2,0,1,CEO
ovo demonhead,1474,2,0,2,0,1,SCR
jesse fong,1474,2,0,2,0,1,SCR
shaggy,1474,2,0,2,0,1,VS Fighting
mochalatteee,1474,2,0,2,0,1,SCR
clipstream casshern,1474,2,0,2,0,1,CEO
hertzshmertz,1474,2,0,2,0,1,SCR
キッド,1474,2,0,2,0,1,Nine States
missingno.,1474,2,0,2,0,1,SCR
shige,1474,2,0,2,0,1,CPTA Last Chance Qualifier
男鴿,1474,2,0,2,0,1,Taiwan
fuzz lightyear,1474,2,0,2,0,1,NorCal Regionals
agilo,1474,8,2,6,25,2,Dreamhack Summer;Red Fight District
tsp|timtastic,1474,2,0,2,0,1,NorCal Regionals
nastynizzzle1,1474,2,0,2,0,1,NorCal Regionals
いす市長,1474,2,0,2,0,1,Nine States
bbs own black_dynowright,1474,2,0,2,0,1,NorCal Regionals
og bunch,1474,2,0,2,0,1,CEO
ramonachan,1474,2,0,2,0,1,First Attack
andywuzc,1474,2,0,2,0,1,Taiwan
choobacca,1474,2,0,2,0,1,CPTA Last Chance Qualifier
honestabe,1474,2,0,2,0,1,SCR
doscubanos,1474,2,0,2,0,1,CEO
zee rinkato,1474,2,0,2,0,1,CEO
insertbrainhere,1474,2,0,2,0,1,VS Fighting
么么小吉吉 么么小吉吉,1474,2,0,2,0,1,CPTA Shanghai
mamobelty,1474,2,0,2,0,1,First Attack
owen tu,1474,2,0,2,0,1,Combo Breaker
scaryeyes,1474,2,0,2,0,1,Combo Breaker
thurrabred,1474,2,0,2,0,1,VS Fighting
squid kid,1474,2,0,2,0,1,CPTA Last Chance Qualifier
gobant,1474,2,0,2,0,1,CEO
drago_drk,1474,2,0,2,0,1,NorCal Regionals
notbab hadoukant,1474,2,0,2,0,1,Combo Breaker
皮皮/pipi,1474,2,0,2,0,1,Taiwan
andrew gib,1474,2,0,2,0,1,NorCal Regionals
v12 hypnos,1474,2,0,2,0,1,NorCal Regionals
goukki,1474,2,0,2,0,1,VS Fighting
og killatofu,1474,2,0,2,0,1,SCR
noggy,1474,2,0,2,0,1,CEO
sanchez,1474,2,0,2,0,1,SCR
dr sharpy,1474,2,0,2,0,1,First Attack
tiger zebra,1474,2,0,2,0,1,VS Fighting
dex masters,1474,2,0,2,0,1,Combo Breaker
sroasha,1474,2,0,2,0,1,CEO
dmf,1474,2,0,2,0,1,NorCal Regionals
bluesy,1474,2,0,2,0,1,SCR
pim118,1474,2,0,2,0,1,NorCal Regionals
dm|mayho,1474,2,0,2,0,1,SCR
gnixer,1474,2,0,2,0,1,CPTA Last Chance Qualifier
gary artairias,1474,2,0,2,0,1,HK
vgd,1474,2,0,2,0,1,CPTA Last Chance Qualifier
大俠趕羚羊,1474,2,0,2,0,1,Taiwan
deanthrax,1474,2,0,2,0,1,CEO
duke,1474,2,0,2,0,1,VS Fighting
sbk,1474,2,0,2,0,1,CPTA Last Chance Qualifier
屠村客,1474,2,0,2,0,1,Taiwan
arcadedreams,1474,2,0,2,0,1,NorCal Regionals
cult of sirlin,1474,2,0,2,0,1,NorCal Regionals
dtflipper,1474,2,0,2,0,1,NorCal Regionals
sean9217,1474,2,0,2,0,1,VS Fighting
昼下がりの団地妻,1474,2,0,2,0,1,Nine States
gorillapino,1474,2,0,2,0,1,NorCal Regionals
hf|tierney,1474,2,0,2,0,1,NorCal Regionals
沈鹏 triple-k,1474,2,0,2,0,1,CPTA Shanghai
legendary mako,1474,2,0,2,0,1,First Attack
megaphonejones66,1474,2,0,2,0,1,VS Fighting
eb mars312xd,1474,2,0,2,0,1,Combo Breaker
chris len,1474,2,0,2,0,1,VS Fighting
the last hairbender,1474,2,0,2,0,1,Combo Breaker
mr. gu,1474,2,0,2,0,1,Combo Breaker
gr redbaron,1474,2,0,2,0,1,Combo Breaker
sfo|savant,1474,2,0,2,0,1,VS Fighting
toneloki,1474,2,0,2,0,1,NorCal Regionals
汪俊峰 fei-long,1474,2,0,2,0,1,CPTA Shanghai
olivo,1474,2,0,2,0,1,First Attack
laziepokekai,1474,2,0,2,0,1,NorCal Regionals
hf|dreiss,1474,2,0,2,0,1,NorCal Regionals
mardon,1474,2,0,2,0,1,Combo Breaker
阿豪,1474,2,0,2,0,1,Taiwan
lostperfection,1474,2,0,2,0,1,CEO
afaliq bin yusof afaliq90,1474,2,0,2,0,1,CPTA Shanghai
japhk,1474,2,0,2,0,1,HK
dux_ryu,1474,2,0,2,0,1,NorCal Regionals
aquamandog,1474,2,0,2,0,1,Combo Breaker
doctor vicious,1474,2,0,2,0,1,CEO
eddydangerous,1474,2,0,2,0,1,NorCal Regionals
jayson,1474,2,0,2,0,1,CPTA Last Chance Qualifier
lucius,1474,2,0,2,0,1,CEO
court,1474,2,0,2,0,1,CEO
majesticstylez,1474,2,0,2,0,1,NorCal Regionals
ken yeung kenyeung,1474,2,0,2,0,1,HK
colonel suave,1474,2,0,2,0,1,First Attack
eyoh_ajax,1474,2,0,2,0,1,Combo Breaker
lee siu kwan dbj_john,1474,2,0,2,0,1,HK
hui chun hin xft-musicwizard,1474,2,0,2,0,1,HK
harpzx007,1474,2,0,2,0,1,VS Fighting
legend of negro,1474,2,0,2,0,1,VS Fighting
one2remember80,1474,2,0,2,0,1,VS Fighting
empr.pxg daytonj,1474,2,0,2,0,1,Combo Breaker
dtjb,1474,2,0,2,0,1,Combo Breaker
kim il songbo,1474,2,0,2,0,1,CPTA Last Chance Qualifier
mba|the bp tank,1474,6,2,4,33,2,Hypespotting;VS Fighting
cheese,1474,2,0,2,0,1,VS Fighting
dath,1474,2,0,2,0,1,Ultra Hyakkishu Cup
archangel,1474,2,0,2,0,1,VS Fighting
teachable,1474,2,0,2,0,1,CEO
rst|ryrie,1474,2,0,2,0,1,Hypespotting
pmcc,1474,2,0,2,0,1,VS Fighting
rokotsu,1474,2,0,2,0,1,Ultra Hyakkishu Cup
fgerizu,1474,2,0,2,0,1,First Attack
dr hype,1474,2,0,2,0,1,Hypespotting
ed|mantis,1474,2,0,2,0,1,VS Fighting
kenneth hystericyuu,1474,2,0,2,0,1,HK
vs hustle crowe,1474,2,0,2,0,1,Hypespotting
nigiri bison,1474,2,0,2,0,1,Ultra Hyakkishu Cup
justincredible47,1474,2,0,2,0,1,CEO
1p,1474,2,0,2,0,1,Ultra Hyakkishu Cup
zds,1474,2,0,2,0,1,Combo Breaker
justin chu darkras,1474,2,0,2,0,1,CPTA Shanghai
deathtattoo83,1474,2,0,2,0,1,Combo Breaker
ornstein,1474,2,0,2,0,1,Hypespotting
chilli_palmer,1474,2,0,2,0,1,CEO
terrymc,1474,2,0,2,0,1,Combo Breaker
exp scythe,1474,2,0,2,0,1,Combo Breaker
pootytangfl,1474,2,0,2,0,1,CEO
ramjam,1474,2,0,2,0,1,Combo Breaker
shunshun,1474,2,0,2,0,1,Ultra Hyakkishu Cup
thores,1474,2,0,2,0,1,Combo Breaker
rst|ruffdawg,1474,2,0,2,0,1,Hypespotting
underage,1474,2,0,2,0,1,Hypespotting
od|dbiohazard,1474,2,0,2,0,1,First Attack
mmg|spuck,1474,2,0,2,0,1,Hypespotting
tissuemon,1474,2,0,2,0,1,Milan Games Week
hugo-andore,1474,2,0,2,0,1,First Attack
lcx lcx1988,1474,2,0,2,0,1,CPTA Shanghai
gr danimal,1474,2,0,2,0,1,Combo Breaker
eligtkderic,1474,2,0,2,0,1,CEO
lee chun ho lee,1474,2,0,2,0,1,HK
onemorething,1474,2,0,2,0,1,Hypespotting
zombie brian,1474,2,0,2,0,1,Hypespotting
midas,1474,2,0,2,0,1,Milan Games Week
j king tha 1st,1474,2,0,2,0,1,Combo Breaker
auto au auto,1474,2,0,2,0,1,HK
opienus,1474,2,0,2,0,1,CEO
squibb,1474,2,0,2,0,1,Milan Games Week
tyson,1474,2,0,2,0,1,CPTA Shanghai
gp romora,1474,2,0,2,0,1,CEO
范伦豪 mars,1474,2,0,2,0,1,CPTA Shanghai
marcorydah,1474,2,0,2,0,1,Milan Games Week
sonimatic14,1474,2,0,2,0,1,CEO
xiaowei xia mohai,1474,2,0,2,0,1,CPTA Shanghai
joel hosty05,1474,2,0,2,0,1,CPTA Shanghai
ashu j,1474,2,0,2,0,1,CEO
hosea fidel,1474,2,0,2,0,1,Hypespotting
supermrjmt,1474,2,0,2,0,1,Combo Breaker
+dq+,1474,2,0,2,0,1,HK
ig|bole,1474,2,0,2,0,1,First Attack
rapidblade05,1474,2,0,2,0,1,Combo Breaker
dpgl menard,1474,2,0,2,0,1,First Attack
lorichumley05 15,1474,2,0,2,0,1,CPTA Shanghai
locojoe,1474,6,2,4,33,2,Combo Breaker;CEO
alteredturbomax,1474,2,0,2,0,1,Milan Games Week
blanco negro,1474,2,0,2,0,1,First Attack
mateo fratus,1474,2,0,2,0,1,Milan Games Week
naryx,1474,2,0,2,0,1,Combo Breaker
alfredoedwards 25 alfredoedwards,1474,2,0,2,0,1,HK
insidious vince,1474,2,0,2,0,1,CEO
yong zhu ddj|yong,1474,2,0,2,0,1,CPTA Shanghai
kyorikusagami,1474,2,0,2,0,1,CEO
terra,1474,2,0,2,0,1,Hypespotting
master sarayut,1474,2,0,2,0,1,Milan Games Week
src grayson,1474,2,0,2,0,1,Combo Breaker
ke3m07,1474,2,0,2,0,1,CPTA Last Chance Qualifier
joe chau jeono,1474,2,0,2,0,1,HK
kush95,1474,2,0,2,0,1,Milan Games Week
aof e-dawg,1474,2,0,2,0,1,CEO
crash,1474,2,0,2,0,1,Milan Games Week
marzipan,1474,2,0,2,0,1,Hypespotting
pand089,1474,2,0,2,0,1,Milan Games Week
nutri96,1474,2,0,2,0,1,Milan Games Week
steve,1474,2,0,2,0,1,Hypespotting
kjb the hero,1474,2,0,2,0,1,Combo Breaker
tuyetmiles9 22,1474,2,0,2,0,1,CPTA Shanghai
flupty,1474,2,0,2,0,1,Hypespotting
sjbm,1474,2,0,2,0,1,Combo Breaker
dmc macc,1474,2,0,2,0,1,Combo Breaker
pez man 81,1474,2,0,2,0,1,Combo Breaker
やまやん,1474,2,0,2,0,1,Nine States
ah xi,1474,2,0,2,0,1,CPTA Shanghai
frootloop,1474,2,0,2,0,1,Combo Breaker
yy 管家仔,1474,2,0,2,0,1,HK
laoghe,1474,2,0,2,0,1,Milan Games Week
ansatsusha,1474,2,0,2,0,1,Hypespotting
frodo,1474,2,0,2,0,1,Combo Breaker
lsteveboxl,1474,2,0,2,0,1,Hypespotting
kiandres,1474,2,0,2,0,1,Milan Games Week
s.i.r. dinky,1474,2,0,2,0,1,Combo Breaker
phantom,1474,2,0,2,0,1,CEO
betterbryan,1474,2,0,2,0,1,Combo Breaker
snoopylooker,1474,2,0,2,0,1,Hypespotting
noahspencer84 19,1474,2,0,2,0,1,CPTA Shanghai
drewmorri7,1474,2,0,2,0,1,Hypespotting
premiumtax,1474,2,0,2,0,1,CEO
sisf,1474,2,0,2,0,1,Combo Breaker
冯云龙 elaialong,1474,2,0,2,0,1,CPTA Shanghai
ed|hawxx is rippin,1474,2,0,2,0,1,Hypespotting
gh dsc thenyion,1474,2,0,2,0,1,CEO
moonrider,1474,2,0,2,0,1,CPTA Last Chance Qualifier
park jkkk hydebuffy,1474,2,0,2,0,1,HK
paul ho,1474,2,0,2,0,1,CPTA Last Chance Qualifier
solidsnaker3d,1474,2,0,2,0,1,CEO
施晓波 820821,1474,2,0,2,0,1,CPTA Shanghai
ghostshock,1474,2,0,2,0,1,Texas Showdown
drm steikachay,1474,2,0,2,0,1,Hypespotting
recon elite,1474,2,0,2,0,1,Combo Breaker
tony tsui gummy2015,1474,2,0,2,0,1,HK
tss atma,1474,2,0,2,0,1,Hypespotting
鲁俊 水表,1474,2,0,2,0,1,CPTA Shanghai
gohancachat,1474,2,0,2,0,1,CEO
大力 3 3之神大力,1474,2,0,2,0,1,CPTA Shanghai
b&b venison,1474,2,0,2,0,1,Combo Breaker
shirkerbee,1474,2,0,2,0,1,Hypespotting
あうぇ４ ｈｇｓｄが,1474,2,0,2,0,1,HK
张文亮 happyport,1474,2,0,2,0,1,CPTA Shanghai
aurorakillian 13 aurorakillian,1474,2,0,2,0,1,HK
ken-kots,1474,2,0,2,0,1,CEO
smbf|vertigo,1473,2,0,2,0,1,VS Fighting
ua|m.betty,1473,4,1,3,25,1,Texas Showdown
captain steel,1473,2,0,2,0,1,VS Fighting
superiorshadow,1473,2,0,2,0,1,CEO
star,1473,2,0,2,0,1,VS Fighting
jkkk,1473,2,0,2,0,1,CPTA KR
volkmair,1473,2,0,2,0,1,VS Fighting
hon yu sum troublemaker,1473,2,0,2,0,1,HK
billy mcgee,1473,2,0,2,0,1,Combo Breaker
krono,1473,2,0,2,0,1,Combo Breaker
rsd beef,1473,2,0,2,0,1,Red Fight District
biscuit,1473,2,0,2,0,1,Northwest Majors
chima,1473,2,0,2,0,1,Combo Breaker
mba|sono,1473,6,2,4,33,2,Hypespotting;VS Fighting
dj storm,1473,2,0,2,0,1,CPTA Last Chance Qualifier
beppe yagami79,1473,2,0,2,0,1,Milan Games Week
marco mazzanti,1473,2,0,2,0,1,Milan Games Week
tekkon,1473,2,0,2,0,1,VS Fighting
deibu,1473,2,0,2,0,1,VS Fighting
jwoods,1473,2,0,2,0,1,VS Fighting
tm robofobe,1472,10,3,7,30,2,Dreamhack Summer;Dreamhack Winter
jay,1472,10,4,6,40,3,CEO;Taiwan;Ultra Hyakkishu Cup
doxus,1472,12,4,8,33,2,Dreamhack Summer;Dreamhack Winter
dark mavid,1472,2,0,2,0,1,TFC
shinobee,1471,8,2,6,25,3,NorCal Regionals;CPTA KR;SCR
floe,1471,3,0,3,0,2,NorCal Regionals;EVO
flapjacket,1470,3,0,3,0,1,NorCal Regionals
dr. cat,1470,5,1,4,20,1,Dreamhack Summer
prowners,1470,4,0,4,0,1,Dreamhack Winter
eg|chocoblanka,1469,12,4,8,33,5,CEO;EVO;Tokyo Game Show;SCR;Ultra Hyakkishu Cup
d.veritas,1469,5,1,4,20,2,CEO;TFC
shonuff122,1469,5,1,4,20,2,CEO;TFC
spabobin,1469,19,7,12,36,5,Nine States;CPTA KR;KSB 2015;TFC;SCR
shivryuken,1468,5,1,4,20,2,Hypespotting;EGX
クンスト,1467,5,1,4,20,2,Nine States;KSB 2015
seventh trumpet,1466,5,1,4,20,2,NorCal Regionals;Northwest Majors
cg projo,1466,5,1,4,20,2,Combo Breaker;CEO
thwisteh,1465,4,0,4,0,1,Dreamhack Winter
潘权迪 xiaoye,1465,5,1,4,20,2,CPTA Shanghai;HK
maven,1465,4,0,4,0,1,Dreamhack Winter
shin oni,1465,5,1,4,20,2,CEO;First Attack
itz mark kin4,1464,3,0,3,0,1,Texas Showdown
du ma guile,1464,3,0,3,0,1,SCR
ghodere,1464,5,1,4,20,2,NorCal Regionals;SCR
rauce,1464,3,0,3,0,1,Texas Showdown
yuki,1464,5,1,4,20,2,CEO;Saigon Cup
bass ns,1463,5,1,4,20,2,Texas Showdown;Combo Breaker
pewpewu,1463,5,1,4,20,2,NorCal Regionals;Northwest Majors
vdon,1463,5,1,4,20,2,NorCal Regionals;Northwest Majors
elicota,1462,3,0,3,0,1,SCR
hyde,1462,4,0,4,0,2,Nine States;Ultra Hyakkishu Cup
0ctopus0nfire,1462,4,0,4,0,2,CEO;Summer Jam
fgdojo|ninio,1462,4,0,4,0,1,Dreamhack Winter
196|patrik,1462,4,0,4,0,1,Dreamhack Winter
rst|launchpad mcross,1462,5,1,4,20,2,Hypespotting;VS Fighting
nake,1462,6,1,5,16,1,Dreamhack Summer
kdit|ren,1461,7,2,5,28,3,Texas Showdown;EVO;EGX
张琦 xiyiji,1459,4,0,4,0,1,CPTA Shanghai
ニア,1459,8,2,6,25,1,Nine States
maguro,1459,4,0,4,0,1,Dreamhack Winter
audriolen,1459,4,0,4,0,2,NorCal Regionals;SCR
pd|n4us,1459,8,2,6,25,3,NorCal Regionals;Northwest Majors;SCR
kata,1457,4,0,4,0,1,Dreamhack Winter
pr0digy_013,1457,5,0,5,0,1,Dreamhack Summer
james deen,1457,9,2,7,22,2,Dreamhack Summer;Dreamhack Winter
kavorca,1457,4,0,4,0,1,Dreamhack Winter
yip kai cheong barlowlism,1456,4,0,4,0,1,HK
opostrophe,1456,4,0,4,0,1,Dreamhack Winter
ronnyrundspark,1456,4,0,4,0,1,Dreamhack Winter
kilmer,1456,4,0,4,0,1,Dreamhack Winter
crosshatched,1455,4,0,4,0,1,Dreamhack Winter
qphj,1455,5,0,5,0,1,Dreamhack Winter
paranoiar,1454,5,0,5,0,1,Dreamhack Summer
gustavo,1454,4,0,4,0,1,Dreamhack Winter
op|kayjay,1454,4,0,4,0,1,Dreamhack Winter
ikea_patrik,1452,5,0,5,0,1,Dreamhack Summer
readyforpowwow,1452,4,0,4,0,2,Texas Showdown;SCR
ifd delusion,1451,4,0,4,0,2,NorCal Regionals;CEO
ムラヲ,1451,4,0,4,0,1,Nine States
theflyingcheese,1451,4,0,4,0,1,Nine States
385wdb|beermir,1451,4,0,4,0,2,Northwest Majors;CEO
radirgy,1450,4,0,4,0,1,VS Fighting
archiba,1450,5,0,5,0,1,Dreamhack Summer
pylo,1446,5,0,5,0,1,Dreamhack Summer
dragonfangs,1445,5,0,5,0,1,Dreamhack Summer
jeparianen,1443,5,0,5,0,1,Dreamhack Summer
あきやま,1427,6,0,6,0,1,Nine States
