Player,Elo,Games,Wins,Loss,%,Attended,Tournaments
rzr|xian,1805,84,66,18,78,12,Final Round;Hypespotting;Stunfest;South East Asia Major;EVO;CPTA Shanghai;KO Fighting Game Festival;Ultra Hyakkishu Cup;Milan Games Week;Canada Cup;CPTA Finals;Dreamhack Winter
md|luffy,1796,78,65,13,83,11,Cannes Winter Clash;Hypespotting;Stunfest;FFM-Rumble;Dreamhack Summer;EVO;VS Fighting;EGX;Red Fight District;Milan Games Week;Dreamhack Winter
r/kappa|infilitration,1792,92,74,18,80,13,Cannes Winter Clash;Nine States;Final Round;NorCal Regionals;CPTA KR;Texas Showdown;Stunfest;South East Asia Major;CEO;EVO;HK;First Attack;Tokyo Game Show
eg|momochi,1776,70,53,17,75,9,Final Round;NorCal Regionals;Stunfest;South East Asia Major;CEO;EVO;SCR;Ultra Hyakkishu Cup;Canada Cup
rzr|fuudo,1759,96,67,29,69,15,Final Round;NorCal Regionals;CPTA KR;Stunfest;South East Asia Major;CEO;EVO;CPTA Shanghai;Tokyo Game Show;KO Fighting Game Festival;Ze Fighting Game Champion;SCR;Ultra Hyakkishu Cup;Milan Games Week;Canada Cup
r/kappa|poongko,1754,70,52,18,74,11,Cannes Winter Clash;Nine States;NorCal Regionals;CPTA KR;Stunfest;FFM-Rumble;South East Asia Major;EVO;Tokyo Game Show;Ultra Hyakkishu Cup;CPTA Finals
be|nemo,1753,45,34,11,75,5,KSB 2015;EVO;Tokyo Game Show;Ultra Hyakkishu Cup;CPTA Finals
rb|bonchan,1752,103,73,30,70,15,Final Round;NorCal Regionals;CPTA KR;KSB 2015;Stunfest;FFM-Rumble;South East Asia Major;CEO;EVO;FV Cup;Tokyo Game Show;SCR;Ultra Hyakkishu Cup;Canada Cup;CPTA Finals
r/kappa|zv|kazunoko,1752,76,57,19,75,11,Final Round;NorCal Regionals;CPTA KR;KSB 2015;Stunfest;South East Asia Major;CEO;EVO;Tokyo Game Show;SCR;Canada Cup
mcz|daigo,1751,45,34,11,75,7,Final Round;NorCal Regionals;Stunfest;South East Asia Major;CEO;EVO;Tokyo Game Show
rb|snake eyez,1750,104,76,28,73,13,Final Round;NorCal Regionals;Texas Showdown;CEO;EVO;CPTA Shanghai;Summer Jam;First Attack;TFC;Tokyo Game Show;SCR;Defend the North;Canada Cup
avm|gamerbee,1741,62,45,17,72,9,Final Round;NorCal Regionals;Stunfest;Dreamhack Summer;South East Asia Major;CEO;EVO;Tokyo Game Show;Canada Cup
mcz|tokido,1728,72,49,23,68,12,Final Round;Hypespotting;CPTA KR;KSB 2015;Stunfest;FFM-Rumble;South East Asia Major;CEO;EVO;CPTA Shanghai;Tokyo Game Show;Canada Cup
liquid|nuckledu,1720,73,51,22,69,11,Final Round;NorCal Regionals;Texas Showdown;Combo Breaker;CEO;EVO;Summer Jam;First Attack;TFC;SCR;Defend the North
qanba douyu|xiaohai,1713,78,54,24,69,11,Cannes Winter Clash;Final Round;South East Asia Major;CEO;EVO;CPTA Shanghai;HK;Saigon Cup;Ze Fighting Game Champion;SCR;CPTA Finals
eg|justin wong,1710,58,40,18,68,11,Final Round;NorCal Regionals;Northwest Majors;Texas Showdown;Combo Breaker;CEO;EVO;TFC;SCR;Defend the North;Canada Cup
tsc|yomi|dieminion,1702,54,37,17,68,9,Cannes Winter Clash;Final Round;CEO;EVO;Summer Jam;TFC;SCR;Defend the North;Canada Cup
kig|problem x,1702,74,54,20,72,10,Cannes Winter Clash;Hypespotting;Dreamhack Summer;VS Fighting;Summer Jam;EGX;Call of Ragnarok;Red Fight District;Defend the North;Dreamhack Winter
eg|ricki ortiz,1700,61,40,21,65,10,Final Round;NorCal Regionals;Northwest Majors;Texas Showdown;Combo Breaker;CEO;EVO;Summer Jam;TFC;Canada Cup
rzr|itabashi zangief,1699,88,60,28,68,15,Nine States;Final Round;CPTA KR;KSB 2015;South East Asia Major;EVO;FV Cup;Taiwan;Manila Cup;Saigon Cup;Tokyo Game Show;KO Fighting Game Festival;Ze Fighting Game Champion;True Challengers Costa Rica;Canada Cup
gl|rb|valmaster,1698,37,24,13,64,7,Cannes Winter Clash;Stunfest;FFM-Rumble;EVO;EGX;Red Fight District;Milan Games Week
mcz|mago,1696,48,34,14,70,9,Final Round;Hypespotting;Stunfest;South East Asia Major;CEO;EVO;Tokyo Game Show;SCR;Canada Cup
fa|ryan hart,1693,74,51,23,68,11,Cannes Winter Clash;Hypespotting;Stunfest;Dreamhack Summer;EVO;KO Fighting Game Festival;EGX;Red Fight District;Milan Games Week;Canada Cup;Dreamhack Winter
wfx|801 strider,1686,71,50,21,70,10,NorCal Regionals;Texas Showdown;CEO;EVO;Summer Jam;First Attack;TFC;SCR;True Challengers Costa Rica;Canada Cup
r/kappa|misse,1681,59,40,19,67,10,Nine States;KSB 2015;South East Asia Major;EVO;Taiwan;HK;Tokyo Game Show;Ultra Hyakkishu Cup;Canada Cup;CPTA Finals
fgcbr|keoma,1680,13,11,2,84,2,CPT Brazil;Dreamhack Winter
ccg|humanbomb,1679,75,51,24,68,12,Abuget Cup;CPTA KR;South East Asia Major;CPTA Shanghai;FV Cup;Taiwan;HK;Manila Cup;Saigon Cup;Tokyo Game Show;Ze Fighting Game Champion;Dreamhack Winter
reversal|chuchu,1678,4,2,2,50,1,CPT Brazil
inco,1675,30,22,8,73,6,Nine States;KSB 2015;EVO;Taiwan;Tokyo Game Show;Ultra Hyakkishu Cup
eg|pr balrog,1674,64,40,24,62,10,Final Round;NorCal Regionals;Northwest Majors;CEO;EVO;Tokyo Game Show;SCR;True Challengers Costa Rica;Canada Cup;CPTA Last Chance Qualifier
rzr|gackt,1673,46,34,12,73,6,South East Asia Major;EVO;FV Cup;Saigon Cup;Ze Fighting Game Champion;CPTA Last Chance Qualifier
eg|k-brad,1673,79,54,25,68,14,Final Round;NorCal Regionals;Texas Showdown;Combo Breaker;CEO;EVO;Summer Jam;First Attack;TFC;Tokyo Game Show;Red Fight District;SCR;Milan Games Week;Canada Cup
fgc|ex pugera,1673,31,23,8,74,4,NorCal Regionals;CEO;First Attack;Ultra Hyakkishu Cup
pie|smug,1673,44,27,17,61,8,Final Round;NorCal Regionals;CEO;EVO;Summer Jam;TFC;Defend the North;Canada Cup
ybk|dashio,1672,21,15,6,71,3,Tokyo Game Show;KO Fighting Game Festival;Ultra Hyakkishu Cup
bx3|phenom,1671,59,41,18,69,9,Cannes Winter Clash;Dreamhack Summer;EVO;Summer Jam;EGX;Call of Ragnarok;Red Fight District;Milan Games Week;Dreamhack Winter
mf|tonpy,1668,80,54,26,67,13,Cannes Winter Clash;KSB 2015;EVO;CPTA Shanghai;FV Cup;Taiwan;HK;Manila Cup;Saigon Cup;Tokyo Game Show;Ze Fighting Game Champion;Ultra Hyakkishu Cup;Milan Games Week
latif,1659,11,8,3,72,2,EVO;KO Fighting Game Festival
neogaf|r/kappa|koji kog,1657,35,23,12,65,6,Northwest Majors;KSB 2015;EVO;Taiwan;Tokyo Game Show;Ultra Hyakkishu Cup
fdy|devil_reapers|dr|stormkubo,1655,30,19,11,63,6,Taiwan;Manila Cup;Tokyo Game Show;Ze Fighting Game Champion;Ultra Hyakkishu Cup;Canada Cup
ybk|shiro,1655,83,54,29,65,15,Nine States;Hypespotting;CPTA KR;KSB 2015;South East Asia Major;EVO;FV Cup;Taiwan;HK;Saigon Cup;Tokyo Game Show;Call of Ragnarok;Ze Fighting Game Champion;Ultra Hyakkishu Cup;Milan Games Week
qanba douyu|dark jiewa,1654,69,46,23,66,11,Abuget Cup;CPTA KR;FFM-Rumble;EVO;CPTA Shanghai;FV Cup;Taiwan;HK;Manila Cup;Saigon Cup;Ze Fighting Game Champion
ts|reiketsu,1654,50,34,16,68,8,KSB 2015;EVO;Taiwan;Manila Cup;SCR;Ultra Hyakkishu Cup;Milan Games Week;Dreamhack Winter
hori|sako,1653,12,8,4,66,2,Cannes Winter Clash;EVO
filipinoman,1650,32,22,10,68,4,Final Round;NorCal Regionals;EVO;SCR
ccg|chris tatarian,1650,20,11,9,55,4,Final Round;NorCal Regionals;EVO;SCR
mba|rize|ind|infexious,1649,44,30,14,68,7,Cannes Winter Clash;Hypespotting;FFM-Rumble;VS Fighting;EGX;Milan Games Week;Dreamhack Winter
kindevu,1648,33,22,11,66,6,South East Asia Major;EVO;Ultra Hyakkishu Cup;Milan Games Week;CPTA Last Chance Qualifier;CPTA Finals
esr|gonzales,1648,89,58,31,65,15,CPTA KR;KSB 2015;EVO;FV Cup;Taiwan;HK;Manila Cup;Saigon Cup;EGX;Call of Ragnarok;Red Fight District;Ultra Hyakkishu Cup;Milan Games Week;Canada Cup;Dreamhack Winter
nishikin,1647,23,13,10,56,5,Nine States;KSB 2015;Manila Cup;Tokyo Game Show;Ultra Hyakkishu Cup
botb|tampa bison,1647,28,19,9,67,6,Final Round;Texas Showdown;CEO;EVO;TFC;Canada Cup
mov,1646,36,20,16,55,7,EVO;HK;Tokyo Game Show;Ultra Hyakkishu Cup;Milan Games Week;Canada Cup;CPTA Finals
ts|arturo sanchez,1645,38,24,14,63,7,Final Round;Northwest Majors;Combo Breaker;CEO;EVO;Defend the North;Canada Cup
ybk|santarouman,1645,17,11,6,64,3,EVO;KO Fighting Game Festival;Ultra Hyakkishu Cup
rokkun,1643,8,6,2,75,1,Ultra Hyakkishu Cup
rzr|rb,1640,30,20,10,66,5,South East Asia Major;FV Cup;Taiwan;HK;Milan Games Week
f-word,1640,12,8,4,66,2,Cannes Winter Clash;VS Fighting
wso|andreas,1639,32,22,10,68,5,Hypespotting;FFM-Rumble;Dreamhack Summer;EGX;Red Fight District
raygo blayde|afii,1639,37,26,11,70,6,Hypespotting;FFM-Rumble;VS Fighting;EGX;Red Fight District;Milan Games Week
ag|ltod|tlod|native impact,1637,22,15,7,68,3,Northwest Majors;CEO;Defend the North
qanba douyu|dakou,1636,46,28,18,60,8,Final Round;CEO;EVO;CPTA Shanghai;HK;Ze Fighting Game Champion;SCR;CPTA Finals
lll|mbr,1636,37,25,12,67,6,Cannes Winter Clash;FFM-Rumble;Dreamhack Summer;EVO;Red Fight District;Dreamhack Winter
yg|yomi|joel,1636,34,22,12,64,7,Final Round;Combo Breaker;CEO;Summer Jam;TFC;SCR;Defend the North
btm|hurricane,1636,21,14,7,66,3,Hypespotting;VS Fighting;EGX
801|ybk|jayce the ace,1636,26,17,9,65,4,Northwest Majors;EVO;SCR;Canada Cup
rize|ind|pro fluke,1635,67,43,24,64,12,Cannes Winter Clash;Hypespotting;FFM-Rumble;Dreamhack Summer;EVO;VS Fighting;EGX;Call of Ragnarok;Red Fight District;Milan Games Week;Canada Cup;Dreamhack Winter
chuan,1634,52,34,18,65,9,Abuget Cup;CPTA KR;FV Cup;Taiwan;HK;Manila Cup;Saigon Cup;Ze Fighting Game Champion;CPTA Last Chance Qualifier
-6,1633,10,6,4,60,2,Tokyo Game Show;Ultra Hyakkishu Cup
ta|chris g,1633,62,40,22,64,9,Final Round;NorCal Regionals;Northwest Majors;Texas Showdown;CEO;EVO;Summer Jam;First Attack;TFC
ccg|air,1631,48,31,17,64,8,Final Round;NorCal Regionals;Northwest Majors;Texas Showdown;Combo Breaker;CEO;SCR;Canada Cup
gagapa,1631,9,6,3,66,2,Stunfest;Red Fight District
r/kappa|aiai,1630,19,13,6,68,3,EVO;Tokyo Game Show;Ultra Hyakkishu Cup
btm|tyrant,1630,40,27,13,67,5,Hypespotting;Dreamhack Summer;VS Fighting;EGX;Red Fight District
um|btm|imstilldadaddy,1628,49,33,16,67,8,Cannes Winter Clash;Final Round;Hypespotting;Dreamhack Summer;VS Fighting;EGX;Red Fight District;Milan Games Week
ybk|kawaguchi,1627,26,15,11,57,5,Nine States;KSB 2015;South East Asia Major;Tokyo Game Show;Ultra Hyakkishu Cup
mom|eh|velociraptor,1627,27,16,11,59,6,Final Round;NorCal Regionals;CEO;EVO;Summer Jam;SCR
r/kappa|alex myers,1626,30,20,10,66,5,NorCal Regionals;Northwest Majors;CEO;EVO;SCR
corn|alucard,1626,34,23,11,67,6,Combo Breaker;CEO;EVO;Summer Jam;TFC;SCR
julio,1625,38,24,14,63,8,Final Round;NorCal Regionals;Northwest Majors;CEO;EVO;Summer Jam;TFC;SCR
r/kappa|kitasenju dj,1623,10,6,4,60,2,Ultra Hyakkishu Cup;Canada Cup
ph|lpn,1622,27,18,9,66,4,Final Round;NorCal Regionals;Northwest Majors;SCR
fgc|r/kappa|pepeday,1622,23,12,11,52,5,Nine States;KSB 2015;EVO;Tokyo Game Show;CPT Brazil
packz,1620,29,17,12,58,6,FFM-Rumble;VS Fighting;EGX;Call of Ragnarok;Red Fight District;Milan Games Week
um|btm|rmz,1619,48,31,17,64,8,Hypespotting;FFM-Rumble;Dreamhack Summer;VS Fighting;EGX;Ze Fighting Game Champion;Milan Games Week;Dreamhack Winter
dl|hamad,1618,10,6,4,60,2,CEO;EVO
bcw|brentt,1618,37,22,15,59,8,Final Round;NorCal Regionals;Northwest Majors;EVO;Summer Jam;TFC;SCR;Canada Cup
botb|marq teddy,1617,14,8,6,57,2,NorCal Regionals;SCR
eita,1615,35,20,15,57,8,CPTA KR;KSB 2015;Stunfest;South East Asia Major;EVO;Tokyo Game Show;Ultra Hyakkishu Cup;Milan Games Week
magneto1080p,1614,9,7,2,77,1,Texas Showdown
sd|pnoy,1612,23,16,7,69,3,NorCal Regionals;EVO;SCR
mor|rico suave,1611,9,6,3,66,3,Final Round;Combo Breaker;EVO
ph|hoodaman,1611,18,10,8,55,3,NorCal Regionals;Northwest Majors;Tokyo Game Show
kok,1610,60,37,23,61,10,Nine States;CPTA KR;KSB 2015;CPTA Shanghai;FV Cup;Taiwan;HK;Saigon Cup;Ze Fighting Game Champion;CPTA Last Chance Qualifier
og|shine,1609,8,4,4,50,2,Summer Jam;Defend the North
dl|four wude,1609,20,14,6,70,5,Final Round;Texas Showdown;CEO;EVO;SCR
bx3|veggey,1606,17,11,6,64,3,Call of Ragnarok;Milan Games Week;Dreamhack Winter
l1|zaferino,1604,14,8,6,57,3,CEO;Summer Jam;Defend the North
ph|nando tovar,1603,19,13,6,68,3,NorCal Regionals;Northwest Majors;SCR
dafeetlee,1603,17,11,6,64,4,Final Round;CEO;Defend the North;Dreamhack Winter
bj unchained,1603,17,10,7,58,4,Final Round;NorCal Regionals;EVO;SCR
cdv|melty|will2pac,1602,23,14,9,60,5,Cannes Winter Clash;EVO;EGX;Red Fight District;Dreamhack Winter
shoryusengan,1601,9,7,2,77,1,Hypespotting
gxc|damascus,1600,23,16,7,69,3,Hypespotting;VS Fighting;Dreamhack Winter
qanba douyu|qqel,1598,12,8,4,66,2,South East Asia Major;CPTA Shanghai
wolfkrone,1598,10,7,3,70,2,Combo Breaker;EVO
fa|big bird,1598,9,7,2,77,1,Dreamhack Winter
hsien chang,1597,32,20,12,62,5,NorCal Regionals;Texas Showdown;CEO;EVO;SCR
elchakotay,1595,9,7,2,77,1,Combo Breaker
ybk|r,1594,11,7,4,63,2,KO Fighting Game Festival;Ultra Hyakkishu Cup
akimo,1594,14,7,7,50,4,Nine States;KSB 2015;Tokyo Game Show;KO Fighting Game Festival
ocv|12m.ocv|riceata,1593,8,5,3,62,2,Defend the North;Canada Cup
sml|solidjin,1593,10,7,3,70,1,VS Fighting
ccg|chi-rithy,1593,10,7,3,70,3,NorCal Regionals;EVO;Canada Cup
gachikun,1591,13,6,7,46,4,KSB 2015;South East Asia Major;EVO;Tokyo Game Show
jehosan,1590,6,4,2,66,1,Cannes Winter Clash
yossan,1590,7,5,2,71,1,Ultra Hyakkishu Cup
cuongster,1590,18,10,8,55,4,Cannes Winter Clash;EGX;Red Fight District;Dreamhack Winter
iz|kaiser,1589,7,5,2,71,1,CPTA Last Chance Qualifier
tsc|sanford kelly,1589,15,7,8,46,4,Final Round;CEO;EVO;Defend the North
wtq8|gannoon,1589,9,6,3,66,1,KO Fighting Game Festival
xiaolong,1589,11,7,4,63,2,Abuget Cup;CPTA Shanghai
kindo,1588,18,12,6,66,3,Nine States;KSB 2015;Ultra Hyakkishu Cup
keno,1585,3,1,2,33,1,Manila Cup
srkuw|botb|fawwaz,1585,16,10,6,62,3,Northwest Majors;CEO;SCR
brawl|haitani,1584,35,21,14,60,7,KSB 2015;EVO;Tokyo Game Show;CPT Brazil;Ultra Hyakkishu Cup;Milan Games Week;CPTA Last Chance Qualifier
r/kappa|hagejin,1584,9,6,3,66,2,Ultra Hyakkishu Cup;Canada Cup
r/kappa|ebi,1583,11,6,5,54,3,FFM-Rumble;Tokyo Game Show;Ultra Hyakkishu Cup
mizoteru,1583,9,6,3,66,1,Nine States
flawless deku,1582,15,10,5,66,2,Hypespotting;EGX
mc|xsk samurai,1582,24,14,10,58,4,NorCal Regionals;Northwest Majors;EVO;SCR
ind.spb|rize|ind|ixion,1582,26,17,9,65,3,Hypespotting;Dreamhack Summer;Dreamhack Winter
btm|gunslinga,1581,11,7,4,63,2,VS Fighting;EGX
vs|rde|edinbulba,1581,12,8,4,66,2,Hypespotting;EGX
gg|epic l.gg|onisan,1580,25,16,9,64,5,Final Round;Texas Showdown;Combo Breaker;CEO;EVO
ph|crackfiend,1578,19,11,8,57,4,NorCal Regionals;Northwest Majors;EVO;SCR
ybk|kichiken,1578,10,6,4,60,2,KO Fighting Game Festival;Ultra Hyakkishu Cup
commander jesse,1577,8,5,3,62,1,SCR
emp|hiro,1577,7,4,3,57,2,Final Round;Defend the North
btm|isam,1576,11,7,4,63,2,VS Fighting;EGX
kelvin jeon,1575,22,13,9,59,4,Final Round;NorCal Regionals;EVO;SCR
wtq8|nox,1575,8,5,3,62,1,KO Fighting Game Festival
apollo steed,1575,9,6,3,66,1,Hypespotting
german luger,1575,11,7,4,63,2,Northwest Majors;Combo Breaker
gl|saunic,1575,20,12,8,60,4,Abuget Cup;Hypespotting;FV Cup;HK
choiboy,1575,6,4,2,66,1,NorCal Regionals
nice1,1572,11,6,5,54,2,Combo Breaker;CEO
qanba douyu|god of sky,1572,25,14,11,56,5,CPTA Shanghai;Manila Cup;Saigon Cup;Ze Fighting Game Champion;CPTA Last Chance Qualifier
pxg|vgp|integra,1571,15,8,7,53,4,Final Round;Texas Showdown;EVO;Defend the North
rize|ind|boltstrike,1571,22,14,8,63,3,Hypespotting;VS Fighting;EGX
rize|ind|btm brian,1571,13,8,5,61,2,Hypespotting;VS Fighting
srkuw you know who it is,1569,5,5,0,100,1,Northwest Majors
db|somniac,1568,9,5,4,55,2,South East Asia Major;CPTA Last Chance Qualifier
vs|rize|ind|milligano,1568,13,9,4,69,2,Hypespotting;VS Fighting
rm emp kdz,1567,15,11,4,73,2,Combo Breaker;CEO
leslie,1567,13,9,4,69,2,FV Cup;CPTA Last Chance Qualifier
vgp|chaotix,1566,17,10,7,58,3,Northwest Majors;Texas Showdown;Canada Cup
iperu,1566,19,11,8,57,3,NorCal Regionals;CEO;SCR
shimauta,1565,9,5,4,55,2,Tokyo Game Show;Ultra Hyakkishu Cup
cast blanka,1565,5,3,2,60,1,CEO
sabohani,1565,7,4,3,57,3,EVO;Tokyo Game Show;Ultra Hyakkishu Cup
lom|wiseblade,1565,12,7,5,58,2,Hypespotting;VS Fighting
isg|eightgrade,1564,8,6,2,75,1,SCR
arika,1564,18,10,8,55,4,KO Fighting Game Festival;Milan Games Week;Canada Cup;CPTA Last Chance Qualifier
easyman,1564,5,3,2,60,1,Milan Games Week
pg|filipino champ,1563,22,12,10,54,6,Final Round;NorCal Regionals;Northwest Majors;EVO;SCR;Canada Cup
ninomae,1563,5,3,2,60,1,Ultra Hyakkishu Cup
30f|street11,1563,1,1,0,100,1,EVO
harideshi,1562,9,5,4,55,3,KSB 2015;EVO;Ultra Hyakkishu Cup
gattikun,1562,10,7,3,70,1,Nine States
brick,1562,12,7,5,58,2,Dreamhack Summer;Dreamhack Winter
mlswear,1560,7,4,3,57,2,Texas Showdown;EVO
kyoku,1560,8,4,4,50,2,Tokyo Game Show;Ultra Hyakkishu Cup
sfo|ghost,1560,9,7,2,77,1,VS Fighting
gz-ben,1560,13,9,4,69,2,CPTA Shanghai;HK
qanba douyu|hurtch_vr,1560,10,6,4,60,2,CPTA Shanghai;Ze Fighting Game Champion
iplay|sheva,1559,7,4,3,57,2,FFM-Rumble;Red Fight District
huanlin,1559,5,3,2,60,1,CPTA Shanghai
gol|ranmasama,1559,18,10,8,55,4,Final Round;CEO;First Attack;Canada Cup
fgc|ooitajin,1559,2,1,1,50,1,Tokyo Game Show
epic|boi toi,1559,5,3,2,60,1,Texas Showdown
bab khangaroo,1558,8,6,2,75,1,Combo Breaker
ugc|vicious,1558,16,8,8,50,3,NorCal Regionals;Northwest Majors;EVO
cublanco,1558,12,8,4,66,2,NorCal Regionals;Texas Showdown
wao,1558,8,4,4,50,2,Tokyo Game Show;Ultra Hyakkishu Cup
qiuqiukof,1558,4,2,2,50,1,South East Asia Major
kenzou,1558,5,3,2,60,1,Ultra Hyakkishu Cup
dogura,1557,17,9,8,52,4,Northwest Majors;KSB 2015;EVO;Ultra Hyakkishu Cup
ybk|kim1234,1557,38,20,18,52,7,Nine States;CPTA KR;KSB 2015;South East Asia Major;FV Cup;Taiwan;Manila Cup
dbkoopa,1557,11,6,5,54,3,Nine States;CPTA KR;EVO
sasaki,1557,5,3,2,60,1,Ultra Hyakkishu Cup
begetaminb,1557,2,1,1,50,1,EVO
cj tajh,1557,15,11,4,73,2,Combo Breaker;CEO
rida,1555,5,5,0,100,1,Texas Showdown
chengfei,1554,8,6,2,75,1,CPTA Shanghai
chow chin pang xft_baoice,1554,6,5,1,83,1,HK
incognitus,1554,9,5,4,55,2,Hypespotting;EGX
alioune85,1554,10,7,3,70,1,Hypespotting
许永宽 斗鱼tv/阿包,1553,6,5,1,83,1,HK
btm|real menace,1553,9,5,4,55,2,VS Fighting;EGX
bars sida,1552,8,6,2,75,1,CEO
laugh,1551,6,3,3,50,1,CPTA KR
magnegro,1551,4,2,2,50,1,CEO
koji miyake,1551,9,6,3,66,2,FV Cup;CPTA Last Chance Qualifier
tbr last dragon,1551,8,6,2,75,1,CEO
soa|ibukiman,1550,6,5,1,83,1,CPT Brazil
anton,1549,11,7,4,63,2,Nine States;KSB 2015
judge ashen,1549,8,6,2,75,1,CEO
ikimashouu,1549,8,6,2,75,1,VS Fighting
hero of time,1549,8,6,2,75,1,CEO
ninja shalz,1548,7,5,2,71,1,EGX
kyabetsu,1548,10,5,5,50,3,Nine States;Tokyo Game Show;Ultra Hyakkishu Cup
evilyoshi,1548,6,3,3,50,1,KO Fighting Game Festival
ta psycho,1548,8,6,2,75,1,CEO
glb,1548,17,9,8,52,4,NorCal Regionals;Combo Breaker;CEO;SCR
koji,1548,2,1,1,50,1,CPTA Last Chance Qualifier
blockbuster jon,1547,12,8,4,66,3,NorCal Regionals;EVO;SCR
vgp|andre west,1547,14,10,4,71,2,Combo Breaker;CEO
ip man,1546,10,7,3,70,1,Texas Showdown
og|rlbs,1546,8,4,4,50,2,CEO;Defend the North
cody,1546,4,2,2,50,1,Abuget Cup
rockpon,1546,11,7,4,63,3,EVO;Taiwan;HK
berserk,1545,7,5,2,71,1,CEO
アミユ,1545,12,8,4,66,1,Nine States
hamago,1545,7,5,2,71,1,Texas Showdown
ind.saltykid,1545,9,6,3,66,1,Dreamhack Summer
demulant,1545,3,1,2,33,1,FFM-Rumble
rize|ind|sfo|omh,1544,7,5,2,71,1,Hypespotting
lll|emersion,1544,14,7,7,50,4,Cannes Winter Clash;Hypespotting;FFM-Rumble;Red Fight District
tones (^_^),1544,8,6,2,75,1,Combo Breaker
image0/nobody,1544,8,6,2,75,1,CEO
onigiri kai,1544,7,5,2,71,1,Taiwan
uryo,1543,3,1,2,33,1,Tokyo Game Show
ramen addict,1543,12,8,4,66,2,NorCal Regionals;CEO
starnab,1543,8,3,5,37,3,Cannes Winter Clash;FFM-Rumble;Red Fight District
clim,1543,13,9,4,69,2,NorCal Regionals;Northwest Majors
gamein,1542,4,2,2,50,1,Red Fight District
holdy,1542,13,9,4,69,2,Combo Breaker;CEO
ttl|shinba,1542,5,2,3,40,2,EVO;Ultra Hyakkishu Cup
lingo,1542,1,0,1,0,1,Final Round
white gun,1542,16,10,6,62,3,NorCal Regionals;Northwest Majors;CEO
ultima,1542,7,5,2,71,1,NorCal Regionals
nayte,1542,8,4,4,50,1,Dreamhack Summer
罗晓虎,1541,6,4,2,66,1,Ze Fighting Game Champion
ph|jame,1541,12,8,4,66,2,NorCal Regionals;Northwest Majors
em cush,1541,7,5,2,71,1,Combo Breaker
codynp,1541,29,17,12,58,5,Hypespotting;CPTA KR;South East Asia Major;Taiwan;HK
evb ds ray,1541,8,5,3,62,1,First Attack
hzy,1540,5,2,3,40,2,Final Round;CPTA Last Chance Qualifier
谭飞 fei,1540,7,5,2,71,1,HK
rsd|momi,1539,1,0,1,0,1,FFM-Rumble
gg|halibel,1539,1,0,1,0,1,FFM-Rumble
vivi,1539,1,0,1,0,1,EVO
wtq8|dudebag,1539,6,4,2,66,1,KO Fighting Game Festival
boeken,1539,12,8,4,66,2,Northwest Majors;SCR
akainu,1539,3,1,2,33,1,Cannes Winter Clash
cj truth,1539,6,4,2,66,1,CEO
1up|van,1539,1,0,1,0,1,Canada Cup
mean saltine,1539,12,8,4,66,2,Northwest Majors;Combo Breaker
sa cuby,1538,7,5,2,71,1,CEO
chaos time,1538,12,8,4,66,2,VS Fighting;EGX
gambleboxer,1538,5,4,1,80,1,CPTA Last Chance Qualifier
m.b.,1538,1,0,1,0,1,EVO
a&c|italdan,1538,4,1,3,25,2,Summer Jam;Canada Cup
tkr,1538,3,1,2,33,1,Cannes Winter Clash
carzydog,1538,3,3,0,100,1,CPTA Last Chance Qualifier
po yuen chan xft_nana,1537,7,5,2,71,1,HK
daimon,1537,7,5,2,71,1,Taiwan
jared,1537,7,5,2,71,1,NorCal Regionals
qanba douyu|kurenai,1537,7,5,2,71,1,CEO
t3p|wrathmatics,1537,11,7,4,63,2,NorCal Regionals;SCR
ninja shinryu,1537,11,7,4,63,2,VS Fighting;EGX
bashfest,1537,17,9,8,52,3,Dreamhack Summer;Call of Ragnarok;Dreamhack Winter
wave foomy,1536,7,5,2,71,1,TFC
danny boy peru,1536,11,7,4,63,2,Combo Breaker;CEO
fge olivo,1536,7,5,2,71,1,CEO
thrillhouse,1536,7,5,2,71,1,NorCal Regionals
silg@st,1536,3,3,0,100,1,FV Cup
stvg asiandemon,1536,6,4,2,66,1,CEO
ral,1536,7,5,2,71,1,Combo Breaker
wataru (japan),1536,7,5,2,71,1,Taiwan
rzr|perfect legend,1535,1,0,1,0,1,EVO
prk ts|huracán azura,1535,8,5,3,62,1,First Attack
espr fga mono,1535,6,4,2,66,1,CEO
hydebuffy,1535,6,4,2,66,2,EVO;Ultra Hyakkishu Cup
robbieq_108,1535,5,4,1,80,1,Hypespotting
kreymore,1535,19,11,8,57,5,Final Round;EVO;First Attack;Defend the North;Dreamhack Winter
sa teamkhris,1535,7,5,2,71,1,CEO
mx|mad,1535,5,4,1,80,1,TFC
el cubano loco,1534,10,6,4,60,3,Northwest Majors;EVO;SCR
damurgood,1534,7,5,2,71,1,Combo Breaker
qanba douyu|abang,1534,6,4,2,66,1,CPTA Shanghai
cocaneta,1534,6,4,2,66,1,First Attack
sd|tempest,1534,10,6,4,60,2,NorCal Regionals;SCR
mob|princess slim,1533,6,4,2,66,1,TFC
orlando,1533,6,4,2,66,1,CEO
「346pro|ＹＡＳＥ」 fog_e,1533,7,5,2,71,1,Combo Breaker
bokkin,1533,10,6,4,60,2,Northwest Majors;SCR
ceo|jebailey,1533,8,5,3,62,2,Combo Breaker;EVO
ckd/ds babushas,1533,7,5,2,71,1,SCR
たーやん,1533,6,4,2,66,1,KSB 2015
fgc|dunhill,1533,10,6,4,60,2,Nine States;Ultra Hyakkishu Cup
stekoh,1532,7,5,2,71,1,FV Cup
valiant,1532,8,5,3,62,1,SCR
coin up|ludovic,1532,11,4,7,36,4,Final Round;Texas Showdown;EVO;Defend the North
mister keebler,1532,10,6,4,60,2,CEO;SCR
stvg crespo,1532,6,4,2,66,1,CEO
dj_malady,1532,7,5,2,71,1,Texas Showdown
qanba douyu|cuishao,1532,10,6,4,60,2,CPTA Shanghai;Ze Fighting Game Champion
rde|akraat,1532,13,8,5,61,2,Hypespotting;VS Fighting
tgl giefkid,1532,7,5,2,71,1,Combo Breaker
眉山拳王,1532,4,3,1,75,1,Ze Fighting Game Champion
manny,1532,3,1,2,33,1,Milan Games Week
akg shinji,1531,6,4,2,66,1,SCR
ab ab,1531,7,4,3,57,1,CPTA Shanghai
brian_f,1531,6,4,2,66,1,CEO
たんげ tange,1531,6,4,2,66,1,Nine States
lorddvd,1531,2,0,2,0,1,Cannes Winter Clash
sd|ilija,1531,6,4,2,66,1,SCR
yomi kush,1530,4,3,1,75,1,TFC
redpanda knuckledust,1530,8,5,3,62,1,TFC
iplay demulant,1530,6,4,2,66,1,Red Fight District
gtr,1530,4,1,3,25,1,Dreamhack Winter
rodney,1530,6,4,2,66,1,CPTA Last Chance Qualifier
brolylegs,1530,9,5,4,55,2,Texas Showdown;EVO
eric m,1530,6,4,2,66,1,CEO
bagelobo,1530,6,4,2,66,1,CEO
근성frs,1530,4,3,1,75,1,CPTA KR
宗慶/k,1530,6,4,2,66,1,Taiwan
chan sau cheong terry,1529,6,4,2,66,1,HK
twiggy,1529,6,2,4,33,2,Tokyo Game Show;Ultra Hyakkishu Cup
rh|f4rhann,1529,6,4,2,66,1,VS Fighting
battousai,1529,6,4,2,66,1,FV Cup
lcx wh1sper,1529,6,4,2,66,1,CPTA Shanghai
damdai,1529,8,3,5,37,4,Final Round;EVO;TFC;Defend the North
ed|vsf|jinty,1529,10,6,4,60,2,Hypespotting;VS Fighting
nekromantik187,1529,7,4,3,57,2,EVO;SCR
hitbox rose,1529,6,4,2,66,1,Taiwan
kay zhong kay(fs),1529,6,4,2,66,1,HK
cxr|@dk_brawler,1529,6,4,2,66,1,Northwest Majors
peejay,1528,6,4,2,66,1,NorCal Regionals
qanba douyu|bei bei,1528,6,4,2,66,1,CPTA Shanghai
flaquito,1528,6,4,2,66,1,SCR
刘斌 sandro,1528,6,4,2,66,1,CPTA Shanghai
bfl|zaus,1528,10,6,4,60,2,Hypespotting;VS Fighting
ce jabdrunk,1528,8,5,3,62,1,NorCal Regionals
corn sethlolol,1528,6,4,2,66,1,Combo Breaker
りゅうきち,1528,6,4,2,66,1,Nine States
kizzie kay,1528,10,6,4,60,2,NorCal Regionals;Northwest Majors
rockdan,1528,6,4,2,66,1,Combo Breaker
goldman,1528,6,4,2,66,1,First Attack
bsc nevillebamshew,1528,8,5,3,62,1,Hypespotting
krhs tan-tan,1527,6,4,2,66,1,CEO
haizek,1527,7,4,3,57,1,First Attack
lee g.y.r.o,1527,6,4,2,66,1,HK
豪鬼王/tomy huang,1527,6,4,2,66,1,Taiwan
shbl tim,1527,6,4,2,66,1,NorCal Regionals
solrac naej,1527,6,4,2,66,1,First Attack
winchester,1527,6,4,2,66,1,Texas Showdown
ma lung fan,1527,8,5,3,62,1,SCR
hadoukenmd,1527,12,7,5,58,2,CEO;TFC
pokchop,1527,11,6,5,54,3,Final Round;CEO;TFC
のえ,1527,10,6,4,60,1,Nine States
cla75,1527,6,4,2,66,1,Milan Games Week
frostynuggs,1527,4,3,1,75,1,Hypespotting
smbg|tangent,1527,10,6,4,60,2,NorCal Regionals;SCR
silg@shaun,1527,6,4,2,66,1,FV Cup
buttermilk chris,1527,6,4,2,66,1,CEO
xtr sd|alexis,1527,6,4,2,66,1,NorCal Regionals
sp anbu kpb teiga,1526,6,4,2,66,1,CEO
shotty,1526,6,4,2,66,1,TFC
可樂ヤン,1526,6,4,2,66,1,Taiwan
royalphlush,1526,6,4,2,66,1,Combo Breaker
bab ura bitchassbitch,1526,6,4,2,66,1,Combo Breaker
rize|ind|alaughinggoblin,1526,10,6,4,60,2,Hypespotting;VS Fighting
iusedoom,1526,6,4,2,66,1,CEO
bcw_bushinstyle,1526,6,4,2,66,1,SCR
dayosha,1526,6,4,2,66,1,CEO
od|chairman,1526,7,4,3,57,1,Texas Showdown
rize|ind|kwiddo,1526,7,4,3,57,1,Dreamhack Winter
miamix-alex,1526,6,4,2,66,1,CEO
o|< (stickman),1526,6,4,2,66,1,VS Fighting
kineda,1526,6,4,2,66,1,NorCal Regionals
a-team pag ne glitch,1525,9,5,4,55,2,CEO;Summer Jam
rbl|ronaldihno,1525,6,4,2,66,1,First Attack
stvg|flocker,1525,11,6,5,54,3,CEO;TFC;Defend the North
rig elchakotay,1525,5,3,2,60,1,Summer Jam
doomsday507,1525,8,5,3,62,2,CEO;True Challengers Costa Rica
何琪 heqi0129,1525,6,4,2,66,1,CPTA Shanghai
steeeeve,1525,6,4,2,66,1,NorCal Regionals
deadmoo5,1525,6,4,2,66,1,Northwest Majors
meu,1525,10,6,4,60,3,KSB 2015;Tokyo Game Show;Ultra Hyakkishu Cup
dkt,1525,10,6,4,60,2,NorCal Regionals;SCR
ninja shackz,1525,5,3,2,60,1,Cannes Winter Clash
triiifector,1525,6,4,2,66,1,CEO
spriggan,1525,6,4,2,66,1,Combo Breaker
dr thomas,1525,6,4,2,66,1,Milan Games Week
qanba douyu|红中大大,1525,6,4,2,66,1,CPTA Shanghai
quiquikof rank 11,1525,6,4,2,66,1,CPTA Shanghai
トモ,1525,6,4,2,66,1,Nine States
nacer,1525,15,9,6,60,3,NorCal Regionals;Northwest Majors;SCR
梁伟知 todayceo,1524,10,6,4,60,2,CPTA Shanghai;HK
prk crank,1524,6,4,2,66,1,First Attack
madjestik,1524,2,0,2,0,1,Cannes Winter Clash
big5ive,1524,6,4,2,66,1,CEO
sfo|benners,1524,10,6,4,60,2,Hypespotting;VS Fighting
mikey r,1524,6,4,2,66,1,NorCal Regionals
mjb,1524,6,4,2,66,1,Combo Breaker
muscle steel sex appeal,1524,6,4,2,66,1,Northwest Majors
bab zachary unitedstates,1524,6,4,2,66,1,Combo Breaker
sfo|brylarke,1524,14,8,6,57,3,Hypespotting;VS Fighting;Milan Games Week
ctrl|unknown,1524,10,6,4,60,2,CEO;TFC
corn ace king,1524,6,4,2,66,1,Combo Breaker
starwin,1524,7,4,3,57,1,Texas Showdown
pent,1524,2,2,0,100,1,Texas Showdown
yomi da knut,1524,6,4,2,66,1,CEO
matsuri,1523,9,3,6,33,3,KSB 2015;Tokyo Game Show;Ultra Hyakkishu Cup
corn bootlegwinner,1523,10,6,4,60,2,Combo Breaker;CEO
viscant,1523,14,8,6,57,3,Combo Breaker;CEO;SCR
brillz,1523,9,5,4,55,1,Dreamhack Summer
ip hoi wang xft_whip,1523,6,4,2,66,1,HK
daniel thia,1523,6,4,2,66,1,CPTA Last Chance Qualifier
wanderlust g33k,1523,6,4,2,66,1,Combo Breaker
prk famous,1523,7,4,3,57,1,First Attack
ikari panda,1523,6,4,2,66,1,Combo Breaker
joe shyne,1523,6,4,2,66,1,CEO
kwyjibo,1523,10,6,4,60,2,NorCal Regionals;CEO
kas_shadow,1523,6,4,2,66,1,Combo Breaker
squall,1523,6,4,2,66,1,Combo Breaker
t3p valiant,1522,6,4,2,66,1,NorCal Regionals
bigbates,1522,6,4,2,66,1,CEO
akimoto akimo,1522,6,4,2,66,1,HK
ohgrr,1522,6,4,2,66,1,Combo Breaker
sfo|zxmx,1522,6,4,2,66,1,VS Fighting
ace unlimited,1522,14,8,6,57,3,Final Round;CEO;TFC
pills,1522,6,4,2,66,1,Combo Breaker
blazing,1522,9,5,4,55,2,CEO;First Attack
shin87,1522,5,3,2,60,1,Milan Games Week
dickson,1522,11,6,5,54,2,Northwest Majors;CEO
zoro,1522,6,4,2,66,1,Taiwan
bab munn3y,1522,6,4,2,66,1,Combo Breaker
alexarandom,1522,5,3,2,60,1,Milan Games Week
pts kool-aid,1522,6,4,2,66,1,Texas Showdown
chiaki,1522,8,5,3,62,1,Nine States
wfga higgs bison,1522,6,4,2,66,1,Combo Breaker
josue,1522,6,4,2,66,1,Texas Showdown
viennahotdog,1522,6,4,2,66,1,SCR
yomi|stan,1522,6,4,2,66,1,CEO
iplay4food,1522,6,4,2,66,1,SCR
阿德,1522,6,4,2,66,1,Taiwan
陳政宏 bemechen,1522,6,4,2,66,1,CPTA Shanghai
jason,1522,6,4,2,66,1,VS Fighting
afi,1522,7,4,3,57,1,Dreamhack Winter
tss|marsh d teach,1522,8,5,3,62,1,Texas Showdown
pun pun,1522,10,6,4,60,2,Hypespotting;VS Fighting
xero,1522,6,4,2,66,1,TFC
和泉康太,1522,6,4,2,66,1,Nine States
@speedbrkr,1521,6,4,2,66,1,Combo Breaker
hypersurge,1521,6,4,2,66,1,Texas Showdown
saulabis,1521,5,3,2,60,1,CPTA KR
frank lotion,1521,6,4,2,66,1,CEO
kiyotea,1521,3,2,1,66,1,EVO
kimlegend,1521,5,3,2,60,1,CPTA KR
kbb mad titan,1521,6,4,2,66,1,CEO
ts min,1521,5,3,2,60,1,CEO
botb|jester,1521,5,3,2,60,1,SCR
illoopail,1521,6,4,2,66,1,Texas Showdown
gol|krucial b,1521,7,4,3,57,1,Texas Showdown
gs|gllty,1521,13,7,6,53,4,Final Round;Northwest Majors;Combo Breaker;CEO
neopunisher,1521,5,3,2,60,1,Milan Games Week
anbu exking,1521,6,4,2,66,1,CEO
hunted chimera,1521,7,4,3,57,1,Texas Showdown
hebrew hammer,1521,6,4,2,66,1,Texas Showdown
lu|alex valle,1520,19,10,9,52,4,Texas Showdown;EVO;TFC;Canada Cup
roman,1520,5,3,2,60,1,SCR
sa justice,1520,6,4,2,66,1,First Attack
arrow,1520,9,5,4,55,2,NorCal Regionals;SCR
wtq8|elcaptain,1520,5,3,2,60,1,KO Fighting Game Festival
ojisan,1520,5,3,2,60,1,Ultra Hyakkishu Cup
天下人,1520,5,3,2,60,1,Ze Fighting Game Champion
srm|the white beast,1520,10,6,4,60,2,Combo Breaker;CEO
y,1520,2,0,2,0,1,Ultra Hyakkishu Cup
keijin,1520,2,0,2,0,1,Ultra Hyakkishu Cup
ryder,1520,5,3,2,60,1,CEO
krash!,1520,5,3,2,60,1,NorCal Regionals
jvdsc txk|mrh,1519,6,4,2,66,1,Texas Showdown
司超 群顿,1519,5,3,2,60,1,CPTA Shanghai
nyanshi,1519,5,3,2,60,1,Ultra Hyakkishu Cup
嘟嘟,1519,5,3,2,60,1,Ze Fighting Game Champion
tkd,1519,5,3,2,60,1,Taiwan
swirlyglasses,1519,6,4,2,66,1,Texas Showdown
keftaroz,1519,5,3,2,60,1,Red Fight District
海龙,1519,5,3,2,60,1,Ze Fighting Game Champion
rv_raihan,1519,5,3,2,60,1,FV Cup
yagami,1519,13,7,6,53,2,Dreamhack Summer;Dreamhack Winter
ag|luckyd,1519,3,0,3,0,2,EVO;Summer Jam
ho wai kit cs/u2,1519,5,3,2,60,1,HK
rize|ind|zain,1519,9,5,4,55,2,Hypespotting;EGX
jarbo,1518,5,3,2,60,1,First Attack
chinoooo,1518,7,4,3,57,1,Dreamhack Winter
daniel ta87,1518,5,3,2,60,1,Milan Games Week
大分人,1518,9,5,4,55,2,Nine States;KSB 2015
futile,1518,5,3,2,60,1,SCR
the mechanic,1518,5,3,2,60,1,CEO
班禅,1518,5,3,2,60,1,Ze Fighting Game Champion
bunsen burner,1518,5,3,2,60,1,Northwest Majors
et,1518,5,3,2,60,1,Taiwan
hunter,1518,7,4,3,57,1,KO Fighting Game Festival
vws|j miller,1518,13,7,6,53,3,Hypespotting;VS Fighting;EGX
scott k wai kit,1518,5,3,2,60,1,FV Cup
cheungyik memory,1518,5,3,2,60,1,HK
wtq8|boxer4ever,1518,5,3,2,60,1,KO Fighting Game Festival
蔡楚锋 528000,1518,5,3,2,60,1,HK
splendidnull,1518,5,3,2,60,1,Milan Games Week
相楽じあじい souraku jiaji,1517,5,3,2,60,1,Nine States
axlshingo,1517,5,3,2,60,1,SCR
op|flcl,1517,5,3,2,60,1,Dreamhack Winter
mookmonster,1517,5,3,2,60,1,NorCal Regionals
j campos,1517,5,3,2,60,1,CEO
duncan,1517,9,5,4,55,2,Northwest Majors;Texas Showdown
solidxpanda,1517,7,4,3,57,1,Texas Showdown
fuzzy,1517,9,5,4,55,2,VS Fighting;EGX
ao omega tom hanks,1517,5,3,2,60,1,CEO
ifd tuboware,1517,5,3,2,60,1,Combo Breaker
ikari no k bison,1517,5,3,2,60,1,Ultra Hyakkishu Cup
nuki,1517,1,1,0,100,1,EVO
pag lionheart,1517,5,3,2,60,1,CEO
silg@duncan,1517,5,3,2,60,1,FV Cup
clangers,1517,9,5,4,55,2,Hypespotting;VS Fighting
zakotou,1516,5,3,2,60,1,Northwest Majors
wtq8|yoni,1516,5,3,2,60,1,KO Fighting Game Festival
tamashiro,1516,5,3,2,60,1,SCR
stephen,1516,5,3,2,60,1,CEO
ymb9|sho,1516,7,4,3,57,1,Hypespotting
taboc1,1516,5,3,2,60,1,CEO
anubis,1516,3,2,1,66,1,Saigon Cup
mel,1516,5,3,2,60,1,SCR
cartoon hero,1516,5,3,2,60,1,SCR
ghos7dini,1516,5,3,2,60,1,SCR
#jarbo,1516,5,3,2,60,1,CEO
gedub|ce|gdb|jabdrunk,1516,9,5,4,55,2,Northwest Majors;SCR
be|kane blueriver,1516,17,9,8,52,4,Northwest Majors;Texas Showdown;Combo Breaker;CEO
kubo kazuo harideshi,1516,5,3,2,60,1,HK
minos,1516,5,3,2,60,1,Taiwan
ettelman,1516,15,6,9,40,3,Dreamhack Summer;Red Fight District;Dreamhack Winter
flako,1516,5,3,2,60,1,CEO
realistic,1516,5,3,2,60,1,CEO
kaleo,1516,5,3,2,60,1,Northwest Majors
ares016,1516,5,3,2,60,1,Taiwan
bravery,1516,5,3,2,60,1,CPTA Last Chance Qualifier
al|servo,1516,5,3,2,60,1,Combo Breaker
vgp|nashfan,1516,5,3,2,60,1,Texas Showdown
okkun,1516,6,3,3,50,2,EVO;Ultra Hyakkishu Cup
schowda,1516,9,5,4,55,2,NorCal Regionals;Northwest Majors
nerdjosh,1516,7,4,3,57,1,TFC
armageddon,1515,5,3,2,60,1,KO Fighting Game Festival
rst richard galloway,1515,5,3,2,60,1,Hypespotting
fno|bobbyblunts,1515,4,2,2,50,1,Defend the North
li joe,1515,1,1,0,100,1,EVO
boss don dekutree,1515,5,3,2,60,1,Hypespotting
atom,1515,5,3,2,60,1,Taiwan
bronxpuertorock,1515,5,3,2,60,1,CEO
唐医生,1515,5,3,2,60,1,Ze Fighting Game Champion
ymb9|pappacrimson,1515,7,4,3,57,1,Hypespotting
3nigmat1c,1515,5,3,2,60,1,Texas Showdown
sww|thebirdlives,1515,5,3,2,60,1,VS Fighting
saman,1515,5,3,2,60,1,Abuget Cup
toby lin,1515,5,3,2,60,1,Taiwan
godzilla,1515,5,3,2,60,1,First Attack
peanutryu,1515,5,3,2,60,1,FV Cup
boochi,1515,5,3,2,60,1,KO Fighting Game Festival
flash metroid,1515,7,4,3,57,2,Final Round;CEO
combo kash,1515,5,3,2,60,1,SCR
陈佳锋 幻镜/magic mirror,1515,5,3,2,60,1,CPTA Shanghai
wong hin chung saisak,1515,5,3,2,60,1,HK
ganguro,1515,5,3,2,60,1,CPTA Last Chance Qualifier
dcb|afterdeath,1515,14,7,7,50,3,CEO;TFC;Defend the North
uvg|noel brown,1515,5,3,2,60,1,First Attack
ちゃー,1515,10,6,4,60,1,Nine States
leung philip yu fat philip leung,1515,5,3,2,60,1,HK
黄之均 mustarday2,1515,5,3,2,60,1,CPTA Shanghai
jojo,1515,10,5,5,50,2,CPTA Shanghai;Dreamhack Winter
will,1515,5,3,2,60,1,First Attack
i body him,1515,5,3,2,60,1,KO Fighting Game Festival
/r/streetfighter chaos goose,1514,5,3,2,60,1,CEO
tom,1514,5,3,2,60,1,Ze Fighting Game Champion
wtq8|mrkingvega,1514,5,3,2,60,1,KO Fighting Game Festival
何浩华 gz.roadman,1514,5,3,2,60,1,HK
sfo|the pro fka pro ho,1514,5,3,2,60,1,VS Fighting
lamerboi,1514,5,3,2,60,1,NorCal Regionals
drenxan,1514,5,3,2,60,1,CEO
majinshinken musa,1514,5,3,2,60,1,KO Fighting Game Festival
mflo,1514,5,3,2,60,1,CPTA Last Chance Qualifier
五股淫棍王,1514,5,3,2,60,1,Taiwan
wong ho ching river,1514,5,3,2,60,1,HK
vaca89,1514,5,3,2,60,1,Milan Games Week
dimmer,1514,5,3,2,60,1,Milan Games Week
loyalsol,1514,5,3,2,60,1,Texas Showdown
dirty paws,1514,5,3,2,60,1,NorCal Regionals
r/sf|v.s. cjbqulix,1514,5,3,2,60,1,SCR
hnh kizzie kay,1514,5,3,2,60,1,SCR
kang 康,1514,5,3,2,60,1,CPTA Shanghai
udlr painbot,1514,5,3,2,60,1,CEO
semboosa,1514,5,3,2,60,1,KO Fighting Game Festival
歐妹/omega,1514,5,3,2,60,1,Taiwan
cb master splinter,1514,5,3,2,60,1,Combo Breaker
el smith,1514,5,3,2,60,1,NorCal Regionals
louzy,1514,5,3,2,60,1,CEO
wtq8|aziz,1514,5,3,2,60,1,KO Fighting Game Festival
コーヒー乳牛 coffee gyuunyuu,1514,5,3,2,60,1,Nine States
iansanity,1514,1,1,0,100,1,EVO
wa private joker,1514,5,3,2,60,1,CEO
mrannual,1514,5,3,2,60,1,CEO
dangief,1513,7,4,3,57,1,Hypespotting
noelbhungry,1513,5,3,2,60,1,TFC
hargi,1513,5,3,2,60,1,NorCal Regionals
そらネコ,1513,3,2,1,66,1,Nine States
chrisdat,1513,7,4,3,57,1,Texas Showdown
mintcheerios,1513,5,3,2,60,1,CPTA KR
shinto~,1513,5,3,2,60,1,Ultra Hyakkishu Cup
sir reginald bigglesworth,1513,5,3,2,60,1,CEO
lom|warteacher,1513,9,5,4,55,2,VS Fighting;EGX
asc.sd alexis pinto,1513,5,3,2,60,1,SCR
baotrung3108,1513,5,3,2,60,1,Saigon Cup
ian,1513,1,1,0,100,1,Canada Cup
ed|lavell up,1513,13,7,6,53,3,Hypespotting;VS Fighting;EGX
kai,1513,5,3,2,60,2,EVO;Ultra Hyakkishu Cup
ruben,1513,5,3,2,60,1,Milan Games Week
[62-bit] finelikewine49,1513,5,3,2,60,1,Northwest Majors
twitch.tv/tuboware,1513,5,3,2,60,1,CEO
k/d_heyzeus775,1513,5,3,2,60,1,NorCal Regionals
weirdoneo,1513,5,3,2,60,1,CPTA KR
wtq8|meshal,1513,5,3,2,60,1,KO Fighting Game Festival
wolf street,1513,9,5,4,55,2,NorCal Regionals;SCR
dawgtanian,1513,9,5,4,55,2,Hypespotting;Ultra Hyakkishu Cup
sfo|whoshabzthisis,1513,5,3,2,60,1,VS Fighting
javits,1513,6,3,3,50,1,First Attack
yomi|shin phoenix,1513,8,4,4,50,2,CEO;TFC
myndgamez,1512,1,1,0,100,1,CEO
wa|dm salpacino,1512,5,3,2,60,1,NorCal Regionals
luken,1512,1,1,0,100,1,Final Round
the best in west palm beach,1512,5,3,2,60,1,CEO
東 xft_tung,1512,5,3,2,60,1,HK
da|johnny fraudeulent,1512,5,3,2,60,1,Texas Showdown
raychun,1512,5,3,2,60,1,Texas Showdown
manualcrowcaine,1512,5,3,2,60,1,CEO
小康,1512,1,1,0,100,1,Taiwan
surruso,1512,5,3,2,60,1,SCR
moey,1512,1,1,0,100,1,Texas Showdown
507 doomsday,1512,1,1,0,100,1,True Challengers Costa Rica
小靠,1512,5,3,2,60,1,Taiwan
sherm,1512,5,3,2,60,1,CEO
pieguy,1512,5,3,2,60,1,NorCal Regionals
tekkablade,1512,5,3,2,60,1,KO Fighting Game Festival
f2g|matos,1512,1,1,0,100,1,EVO
duffman,1512,5,3,2,60,1,CEO
idgaf nytmare_raven,1512,5,3,2,60,1,Texas Showdown
han fengshui,1512,4,2,2,50,1,CPTA Shanghai
roccblaze,1512,5,3,2,60,1,SCR
张尧 haveshit,1512,5,3,2,60,1,CPTA Shanghai
cwalker special,1512,5,3,2,60,1,SCR
sherryjenix,1512,26,14,12,53,6,NorCal Regionals;Texas Showdown;Combo Breaker;CEO;TFC;SCR
thereflexwonder,1512,5,3,2,60,1,CEO
llama,1512,5,3,2,60,1,Texas Showdown
dinlee,1512,5,3,2,60,1,SCR
chg joeystorm,1512,5,3,2,60,1,Northwest Majors
ryoji masaki chanson,1512,5,3,2,60,1,HK
wongtoutou,1512,5,3,2,60,1,CPTA Last Chance Qualifier
vs|bigfool,1511,10,5,5,50,2,Hypespotting;EVO
finalsweek,1511,5,3,2,60,1,Texas Showdown
sda fiercekyo,1511,5,3,2,60,1,CEO
hcliam,1511,5,3,2,60,1,VS Fighting
fabio zeta,1511,5,3,2,60,1,Milan Games Week
phdinspd,1511,5,3,2,60,1,NorCal Regionals
nyc yuusha,1511,5,3,2,60,1,CEO
deku deku tree,1511,8,4,4,50,2,EGX;Red Fight District
yomi glass sword,1511,5,3,2,60,1,Combo Breaker
dm john b,1511,5,3,2,60,1,NorCal Regionals
callisto,1511,5,3,2,60,1,Combo Breaker
ua|brandon chun,1511,5,3,2,60,1,Texas Showdown
bsc|shek,1511,13,7,6,53,3,Hypespotting;VS Fighting;EGX
bars rida,1511,5,3,2,60,1,CEO
gankula,1511,5,3,2,60,1,CEO
xaiah,1511,5,3,2,60,1,TFC
noob_player,1511,5,3,2,60,1,KO Fighting Game Festival
vs|the janitor,1511,5,3,2,60,1,VS Fighting
周怿 angle,1511,5,3,2,60,1,HK
assan chop,1511,5,3,2,60,1,Texas Showdown
iron bullet,1511,5,3,2,60,1,Hypespotting
cprbeastlybubble,1511,5,3,2,60,1,SCR
ig|zonvolt,1511,5,3,2,60,1,First Attack
hogosha,1511,5,3,2,60,1,Combo Breaker
ee eseif,1510,5,3,2,60,1,Combo Breaker
ba b_5,1510,5,3,2,60,1,Milan Games Week
goldteamrules,1510,5,3,2,60,1,CEO
trevonte,1510,5,3,2,60,1,NorCal Regionals
tong ka wing kawing,1510,5,3,2,60,1,HK
ce|cd|kumo,1510,8,4,4,50,2,NorCal Regionals;SCR
rr|mr gork,1510,5,3,2,60,1,First Attack
シロマティ,1510,4,2,2,50,1,KSB 2015
smbg|bakedmotatoes,1510,5,3,2,60,1,NorCal Regionals
the lyl3,1510,5,3,2,60,1,Milan Games Week
yabukistyle,1510,5,3,2,60,1,Northwest Majors
cities,1510,5,3,2,60,1,Combo Breaker
shazy,1510,5,3,2,60,1,Hypespotting
superfabiano,1510,5,3,2,60,1,Milan Games Week
korea player,1510,5,3,2,60,1,Nine States
hf|hainix,1510,9,5,4,55,2,NorCal Regionals;Northwest Majors
the time dictator,1510,9,5,4,55,2,CEO;SCR
suktuck,1510,5,3,2,60,1,FV Cup
christopher lo greenboxer,1510,5,3,2,60,1,HK
raich,1510,5,3,2,60,1,Texas Showdown
kingquaka,1510,5,3,2,60,1,Hypespotting
倪康 duang,1510,5,3,2,60,1,CPTA Shanghai
bab yee kwang soo,1510,5,3,2,60,1,Combo Breaker
太虎,1510,5,3,2,60,1,Ze Fighting Game Champion
lilsicx,1510,5,3,2,60,1,NorCal Regionals
diddy sinatra,1510,5,3,2,60,1,Combo Breaker
joeycl,1510,5,3,2,60,1,Northwest Majors
dbc,1510,5,3,2,60,1,TFC
luis,1510,5,3,2,60,1,Combo Breaker
izzy,1510,5,3,2,60,1,Combo Breaker
bsc|ultrasquaddy,1510,9,5,4,55,2,Hypespotting;EGX
catchtheselegs,1510,5,3,2,60,1,Combo Breaker
王辉 dexter hui,1510,5,3,2,60,1,CPTA Shanghai
tgz|wt kami,1510,5,3,2,60,1,SCR
engravings,1510,5,3,2,60,1,TFC
cs icedarkness,1510,5,3,2,60,1,CEO
cn,1510,5,3,2,60,1,Taiwan
ajay,1510,8,4,4,50,2,Hypespotting;EGX
t.j. bison,1510,5,3,2,60,1,Combo Breaker
つけめん,1510,5,3,2,60,1,Nine States
azteczar,1510,5,3,2,60,1,Combo Breaker
falcomist,1510,5,3,2,60,1,NorCal Regionals
exfinitus,1510,5,3,2,60,1,CEO
the street writer,1510,7,4,3,57,1,Hypespotting
micronukex,1510,5,3,2,60,1,CEO
burnside the gr8,1510,5,3,2,60,1,CEO
q,1510,5,3,2,60,1,Combo Breaker
gibran,1510,5,3,2,60,1,First Attack
noornabelsi,1510,5,3,2,60,1,KO Fighting Game Festival
黄祥 been gor,1510,5,3,2,60,1,HK
bsida,1510,5,3,2,60,1,Texas Showdown
rde|sleight,1510,5,3,2,60,1,Hypespotting
rikkafresh,1510,5,3,2,60,1,TFC
龜仙人,1510,5,3,2,60,1,Taiwan
chenzhou,1510,5,3,2,60,1,CPTA Shanghai
mazinkaiser,1510,5,3,2,60,1,Milan Games Week
online scrub|kaos,1510,5,3,2,60,1,Texas Showdown
ほるもん,1510,5,3,2,60,1,Nine States
adzi,1510,5,3,2,60,1,VS Fighting
kruzee,1510,5,3,2,60,1,CEO
sww|baconjacob,1510,5,3,2,60,1,VS Fighting
udlr highbeast,1510,5,3,2,60,1,CEO
qed,1510,5,3,2,60,1,NorCal Regionals
郑凯 znk,1510,5,3,2,60,1,CPTA Shanghai
sephro8h89,1509,5,3,2,60,1,Milan Games Week
clev,1509,5,3,2,60,1,VS Fighting
haber,1509,5,3,2,60,1,CEO
salty kid,1509,6,3,3,50,1,Dreamhack Winter
sonydafa,1509,5,3,2,60,1,CPTA Shanghai
bifu|spabrog,1509,4,2,2,50,1,Defend the North
mikey g,1509,5,3,2,60,1,CEO
gameguys naughty munkey,1509,5,3,2,60,1,Texas Showdown
shaun,1509,6,3,3,50,1,Saigon Cup
pepeding,1509,4,2,2,50,1,Ze Fighting Game Champion
sft|guiller br,1509,4,2,2,50,1,CPT Brazil
sasa,1509,10,5,5,50,2,Taiwan;Ultra Hyakkishu Cup
better metal dingo,1509,5,3,2,60,1,CEO
bigvic340,1509,5,3,2,60,1,CEO
renegad,1509,4,2,2,50,1,Cannes Winter Clash
totallydrew,1509,5,3,2,60,1,CEO
abyss gouken respek,1509,5,3,2,60,1,CEO
mba|dread,1509,9,5,4,55,2,Hypespotting;VS Fighting
rm|t-boykin,1509,5,3,2,60,1,Texas Showdown
tuan mario,1509,6,3,3,50,1,Saigon Cup
ben-nu,1509,5,3,2,60,1,Taiwan
m. crash,1509,5,3,2,60,1,First Attack
谢文斌 dudu,1508,8,4,4,50,2,CPTA Shanghai;HK
mmg|abswing,1508,8,4,4,50,2,Hypespotting;VS Fighting
ed|aixy,1508,5,3,2,60,1,VS Fighting
kaworu,1508,5,3,2,60,1,VS Fighting
giezoe,1508,5,3,2,60,1,Taiwan
butterbeefbison,1508,13,6,7,46,3,Cannes Winter Clash;Hypespotting;Red Fight District
bobbis,1508,6,3,3,50,1,Dreamhack Winter
dcb dark child,1508,4,2,2,50,1,Summer Jam
niine90,1508,4,2,2,50,1,Red Fight District
koichi,1508,4,2,2,50,1,Ultra Hyakkishu Cup
bcw|c3g|blaqskillz,1508,9,5,4,55,3,NorCal Regionals;EVO;SCR
gunner85,1508,5,3,2,60,1,KO Fighting Game Festival
ind.king funk,1507,9,4,5,44,1,Dreamhack Summer
rize|ind|thunderbear,1507,4,2,2,50,1,Call of Ragnarok
fuhajin,1507,6,1,5,16,2,Cannes Winter Clash;Red Fight District
pahn,1507,4,2,2,50,1,Milan Games Week
smbf walkerfam,1507,4,2,2,50,1,EGX
big mara ramiz,1507,4,2,2,50,1,Red Fight District
shadowchild,1507,4,2,2,50,1,First Attack
dmansland,1507,9,5,4,55,2,Texas Showdown;SCR
xx your disease,1507,4,2,2,50,1,Texas Showdown
twg arthur,1507,4,2,2,50,1,Texas Showdown
yeral,1506,4,2,2,50,1,First Attack
mr.c,1506,4,2,2,50,1,Combo Breaker
ind a laughing goblin,1506,4,2,2,50,1,EGX
cex|goukifafa,1506,14,7,7,50,3,Hypespotting;VS Fighting;Red Fight District
pxg wiseguy,1506,4,2,2,50,1,CEO
glasgow kev,1506,4,2,2,50,1,Hypespotting
max ng,1506,4,2,2,50,1,FV Cup
wso|logan,1506,8,4,4,50,2,Hypespotting;VS Fighting
薛國斌 wo鵝鵝澳•餓痾澳，我比豬腰你聞,1506,4,2,2,50,1,HK
tanka tanky,1506,8,4,4,50,1,CPTA Last Chance Qualifier
lom|luckboxq,1506,9,5,4,55,2,VS Fighting;EGX
lll doomdomainn,1505,4,2,2,50,1,Red Fight District
vivaldi,1505,4,2,2,50,1,CEO
iim83man,1505,4,2,2,50,1,CPTA KR
prettyminky,1505,4,2,2,50,1,CPTA KR
k tousen,1505,4,2,2,50,1,Texas Showdown
srm_leonil,1505,4,2,2,50,1,CEO
juicyjoe,1505,4,2,2,50,1,Dreamhack Winter
3e.ttf|unprotectedsex,1505,4,2,2,50,1,SCR
ccg|snafoo,1505,5,2,3,40,2,EVO;Canada Cup
soa|xr prometo,1505,4,2,2,50,1,CPT Brazil
yogadon,1505,4,2,2,50,1,NorCal Regionals
haywad,1505,4,2,2,50,1,NorCal Regionals
ローキン,1505,4,2,2,50,1,KSB 2015
syn chuck,1505,4,2,2,50,1,EGX
tg|bebedero,1505,2,1,1,50,1,True Challengers Costa Rica
hismit,1505,4,2,2,50,1,Saigon Cup
heodzodzien,1505,4,2,2,50,1,Saigon Cup
seinken,1505,4,2,2,50,1,CEO
prototype,1505,4,2,2,50,1,TFC
scha,1505,4,2,2,50,1,Northwest Majors
pag|sabo,1505,12,6,6,50,3,CEO;Summer Jam;First Attack
こま,1505,4,2,2,50,1,KSB 2015
dixon,1505,2,1,1,50,1,CPTA Last Chance Qualifier
fubarduck,1505,4,2,2,50,1,KSB 2015
um makai,1505,4,2,2,50,1,EGX
刘锦发 chilunsin,1505,6,3,3,50,1,HK
darkhonor90,1504,4,2,2,50,1,CEO
oitajin,1504,4,2,2,50,1,Ultra Hyakkishu Cup
matador kiririnshi25,1504,4,2,2,50,1,Combo Breaker
ua nori,1504,4,2,2,50,1,Texas Showdown
snake belmont,1504,4,2,2,50,1,EGX
disabel,1504,4,2,2,50,1,NorCal Regionals
joyfull78,1504,4,2,2,50,1,CPTA KR
lucamago,1504,4,2,2,50,1,Milan Games Week
mullen,1504,4,2,2,50,1,CPTA KR
lutak,1504,4,2,2,50,1,Ze Fighting Game Champion
kaising,1504,4,2,2,50,1,SCR
jimli,1504,8,4,4,50,2,Northwest Majors;CEO
ce|boba tapioca,1504,4,2,2,50,1,NorCal Regionals
lom buffalo,1504,4,2,2,50,1,EGX
@deejonious,1504,4,2,2,50,1,CEO
kino,1504,4,2,2,50,1,NorCal Regionals
必然也,1504,4,2,2,50,1,Ze Fighting Game Champion
rao,1504,4,2,2,50,1,CEO
200yen,1504,4,2,2,50,1,NorCal Regionals
super uriajjo,1504,4,2,2,50,1,Ultra Hyakkishu Cup
rugalitarian,1504,4,2,2,50,1,CEO
dunbine,1504,4,2,2,50,1,CPTA KR
sa kooky,1504,4,2,2,50,1,CEO
icrossj,1504,4,2,2,50,1,SCR
yomi cardell,1504,4,2,2,50,1,CEO
n1 kupo,1504,4,2,2,50,1,Northwest Majors
dn sf4killedus,1504,4,2,2,50,1,Red Fight District
failichawy iori-q8,1504,4,2,2,50,1,KO Fighting Game Festival
bruin,1504,4,2,2,50,1,SCR
willgetpaid,1504,4,2,2,50,1,NorCal Regionals
danphan,1504,4,2,2,50,1,NorCal Regionals
cc armoredx,1504,4,2,2,50,1,Combo Breaker
tommy gunzss,1504,6,3,3,50,1,Texas Showdown
hf yoga,1504,4,2,2,50,1,SCR
devon scheer,1504,4,2,2,50,1,CEO
kurokiba,1504,4,2,2,50,1,NorCal Regionals
anbu gasstationhobo,1504,4,2,2,50,1,CEO
沈震宇 凶肯,1504,4,2,2,50,1,CPTA Shanghai
carlos c,1503,4,2,2,50,1,CEO
rde sefsins,1503,4,2,2,50,1,Hypespotting
cc,1503,4,2,2,50,1,SCR
billy wong billy,1503,4,2,2,50,1,HK
bonkler,1503,4,2,2,50,1,Combo Breaker
はげじん,1503,4,2,2,50,1,Nine States
joshua alexander,1503,8,4,4,50,2,Texas Showdown;Combo Breaker
jono dori,1503,4,2,2,50,1,CEO
ifrit,1503,4,2,2,50,1,First Attack
hideo,1503,4,2,2,50,1,Saigon Cup
lenard,1503,4,2,2,50,1,CPTA Last Chance Qualifier
jhunie,1503,4,2,2,50,1,NorCal Regionals
sion,1503,4,2,2,50,1,Taiwan
ray,1503,4,2,2,50,1,HK
ymb 9 shinzou,1503,4,2,2,50,1,Hypespotting
mint310,1503,4,2,2,50,1,Ze Fighting Game Champion
tgu zhedloo,1503,3,1,2,33,1,South East Asia Major
dum yao ah,1503,4,2,2,50,1,Northwest Majors
redmage138,1503,4,2,2,50,1,TFC
kumasa,1503,4,2,2,50,1,Taiwan
txs raph,1503,4,2,2,50,1,Texas Showdown
image,1503,4,2,2,50,1,Texas Showdown
iplay halibel,1503,4,2,2,50,1,Red Fight District
flashy,1503,4,2,2,50,1,Saigon Cup
rising superstar alfie,1503,4,2,2,50,1,EGX
大盗,1503,4,2,2,50,1,Ze Fighting Game Champion
anbu sonyono,1503,3,1,2,33,1,Summer Jam
trainerfox,1503,4,2,2,50,1,KO Fighting Game Festival
leung yau chun tomo,1503,4,2,2,50,1,HK
nake @iran #32,1503,4,2,2,50,1,Dreamhack Winter
templar,1503,4,2,2,50,1,Milan Games Week
delfonik,1503,4,2,2,50,1,CEO
eta ralstaanley,1503,4,2,2,50,1,Texas Showdown
dan krolikowski,1503,4,2,2,50,1,Combo Breaker
frisco,1503,4,2,2,50,1,Northwest Majors
pgfx kiu,1503,4,2,2,50,1,Combo Breaker
smbf|yts buttface,1503,4,2,2,50,1,VS Fighting
falling charlie,1503,4,2,2,50,1,CEO
seedogpoo,1502,8,4,4,50,2,CEO;First Attack
fsr wupai,1502,4,2,2,50,1,CEO
小武,1502,4,2,2,50,1,Taiwan
noc|leviathan,1502,8,4,4,50,2,Northwest Majors;SCR
starks,1502,4,2,2,50,1,CEO
spanky,1502,4,2,2,50,1,Ultra Hyakkishu Cup
gpl- flashkoto,1502,4,2,2,50,1,NorCal Regionals
da|scottfree,1502,4,2,2,50,1,Texas Showdown
xiao jj,1502,4,2,2,50,1,CPTA Shanghai
smash,1502,4,2,2,50,1,Hypespotting
david shen,1502,4,2,2,50,1,Taiwan
阿光,1502,4,2,2,50,1,Taiwan
fno|crazysalvi,1502,3,1,2,33,1,Defend the North
rs|d4rk onion,1502,4,2,2,50,1,Hypespotting
tosfhq sj,1502,4,2,2,50,1,CEO
sailor venus,1502,4,2,2,50,1,NorCal Regionals
玩具,1502,4,2,2,50,1,Taiwan
volibear,1502,4,2,2,50,1,KO Fighting Game Festival
two75,1502,4,2,2,50,1,FV Cup
yoro,1502,4,2,2,50,1,Taiwan
/r/sf|rawbertson,1502,2,1,1,50,1,Canada Cup
shorjewken,1502,4,2,2,50,1,Northwest Majors
快打傳奇lanlan,1502,4,2,2,50,1,Taiwan
fgc|sekiganryu,1502,4,2,2,50,1,Ultra Hyakkishu Cup
polarbite,1502,4,2,2,50,1,CEO
joser,1502,4,2,2,50,1,NorCal Regionals
iplay|yougenius,1502,7,3,4,42,2,FFM-Rumble;Red Fight District
黃勇 rc,1502,4,2,2,50,1,HK
邓志聪 dunk,1502,4,2,2,50,1,HK
ita77u,1502,4,2,2,50,1,Milan Games Week
fitri amir,1502,4,2,2,50,1,FV Cup
leong teng fai,1502,4,2,2,50,1,FV Cup
hamu chan,1502,4,2,2,50,1,KO Fighting Game Festival
べにふーき,1502,4,2,2,50,1,Nine States
fv bison wong,1502,4,2,2,50,1,FV Cup
kung sai kit xft_saiki,1502,4,2,2,50,1,HK
dario,1502,4,2,2,50,1,Milan Games Week
re: dandy cage,1502,4,2,2,50,1,Texas Showdown
elton,1502,4,2,2,50,1,CPTA Last Chance Qualifier
j. caesar ii,1502,4,2,2,50,1,CEO
shin rico suave,1502,4,2,2,50,1,CEO
d4rkn3ss aveng,1502,4,2,2,50,1,VS Fighting
lamas,1502,4,2,2,50,1,Dreamhack Winter
chan king kiu cs|fa,1502,4,2,2,50,1,HK
riktigsfivspelare,1502,4,2,2,50,1,Dreamhack Winter
emerald chaos,1502,4,2,2,50,1,Hypespotting
orikasa,1502,4,2,2,50,1,Northwest Majors
rs doom,1502,4,2,2,50,1,EGX
jc,1502,4,2,2,50,1,SCR
criminaldada,1501,4,2,2,50,1,Taiwan
derrick legend,1501,11,5,6,45,3,Combo Breaker;CEO;Summer Jam
dian,1501,4,2,2,50,1,Abuget Cup
そぼろんぐ,1501,8,4,4,50,1,Nine States
toucan steve,1501,4,2,2,50,1,CEO
jimmy hon maskjimmy,1501,4,2,2,50,1,HK
tacaño2dgod,1501,4,2,2,50,1,First Attack
stuntastic,1501,4,2,2,50,1,Combo Breaker
胡寅辰 justin hu,1501,4,2,2,50,1,CPTA Shanghai
小嘉米 木有黑眼圈,1501,4,2,2,50,1,CPTA Shanghai
fancylaine,1501,4,2,2,50,1,Milan Games Week
00g juiceman,1501,4,2,2,50,1,CEO
nakahara,1501,4,2,2,50,1,Ultra Hyakkishu Cup
um lemon,1501,4,2,2,50,1,EGX
da 206 80z,1501,4,2,2,50,1,Northwest Majors
strider,1501,6,3,3,50,1,Hypespotting
nicktanella,1501,4,2,2,50,1,NorCal Regionals
gatk dr sloan,1501,4,2,2,50,1,Hypespotting
ssvs-allen,1501,4,2,2,50,1,Taiwan
謝漢傑,1501,4,2,2,50,1,Taiwan
tyram,1501,4,2,2,50,1,NorCal Regionals
sherman,1501,4,2,2,50,1,CPTA Last Chance Qualifier
faisaldante23,1501,4,2,2,50,1,Hypespotting
サエ,1501,4,2,2,50,1,Nine States
kapwan,1501,4,2,2,50,1,NorCal Regionals
droomighty,1501,4,2,2,50,1,Northwest Majors
sba big arch,1501,4,2,2,50,1,NorCal Regionals
marshall king,1501,4,2,2,50,1,TFC
sorawings,1501,4,2,2,50,1,CPTA KR
finalzero,1501,4,2,2,50,1,KO Fighting Game Festival
eh nd|majintenshinhan,1501,4,2,2,50,1,Dreamhack Winter
ed|the claw of god,1501,4,2,2,50,1,VS Fighting
g-dragon,1501,4,2,2,50,1,NorCal Regionals
mr. mishida,1501,4,2,2,50,1,Texas Showdown
ric104,1501,4,2,2,50,1,Combo Breaker
rde saltmine,1501,4,2,2,50,1,Hypespotting
lushylushy,1501,4,2,2,50,1,Northwest Majors
dfw|saltime,1501,2,1,1,50,1,Defend the North
wtq8|fizzie,1501,4,2,2,50,1,KO Fighting Game Festival
ngi lom wiseblade,1501,4,2,2,50,1,EGX
moe,1501,4,2,2,50,1,Dreamhack Winter
smbf|nebbiez,1501,4,2,2,50,1,VS Fighting
karmaa,1501,4,2,2,50,1,NorCal Regionals
mulverrine,1501,4,2,2,50,1,CPTA KR
jinzou,1501,4,2,2,50,1,Ultra Hyakkishu Cup
eugene yap,1501,4,2,2,50,1,FV Cup
srkuw|kpop,1501,4,2,2,50,1,Northwest Majors
rde ind gillstolemyride,1501,4,2,2,50,1,Hypespotting
solphum,1501,4,2,2,50,1,SCR
pauly z,1501,4,2,2,50,1,Texas Showdown
chg combo kin,1501,4,2,2,50,1,Northwest Majors
canesmoke,1501,4,2,2,50,1,Milan Games Week
datc,1500,4,2,2,50,1,Northwest Majors
fi3nd x godmode,1500,4,2,2,50,1,VS Fighting
frametrap|the prince,1500,4,2,2,50,1,Dreamhack Winter
bombskeez,1500,4,2,2,50,1,SCR
张意,1500,4,2,2,50,1,Ze Fighting Game Champion
ccg|lapchi,1500,3,1,2,33,2,EVO;Canada Cup
naio,1500,4,2,2,50,1,Ultra Hyakkishu Cup
yeti,1500,4,2,2,50,1,Northwest Majors
coccocco713,1500,4,2,2,50,1,Milan Games Week
30f|slayer-san,1500,4,2,2,50,1,Northwest Majors
dumabalrog,1500,4,2,2,50,1,SCR
c-los,1500,4,2,2,50,1,NorCal Regionals
biobillybonez,1500,8,4,4,50,2,NorCal Regionals;SCR
flavored,1500,4,2,2,50,1,CEO
raion,1500,4,2,2,50,1,CEO
张嘉程 fat dog,1500,4,2,2,50,1,CPTA Shanghai
emo,1500,4,2,2,50,1,Northwest Majors
ippolit,1500,4,2,2,50,1,Dreamhack Winter
nb sol ronin,1500,4,2,2,50,1,Combo Breaker
vs gm punk,1500,6,3,3,50,1,Hypespotting
ponzaman,1500,7,3,4,42,2,Ultra Hyakkishu Cup;Milan Games Week
tong,1500,4,2,2,50,1,Combo Breaker
sachiko,1500,4,2,2,50,1,CPTA Last Chance Qualifier
lau chi hung joe gameouttt,1500,4,2,2,50,1,HK
张鸣 niku,1500,4,2,2,50,1,CPTA Shanghai
doom,1500,4,2,2,50,1,Hypespotting
sfo jlm,1500,4,2,2,50,1,EGX
邢岚 烤鱼,1500,4,2,2,50,1,CPTA Shanghai
jabe xft jabe,1500,4,2,2,50,1,HK
dirty dan,1500,4,2,2,50,1,SCR
harumii,1500,4,2,2,50,1,Ultra Hyakkishu Cup
[anet]nightmare2450,1500,4,2,2,50,1,Northwest Majors
bsc|ruok,1500,8,4,4,50,2,Hypespotting;VS Fighting
voltrix,1500,4,2,2,50,1,FV Cup
m a d w a k,1500,4,2,2,50,1,Combo Breaker
ricky xft_softegg,1500,4,2,2,50,1,HK
yomi saltface,1500,2,1,1,50,1,Combo Breaker
veym|noobster,1500,4,2,2,50,1,Texas Showdown
vgp joe love,1500,4,2,2,50,1,Texas Showdown
jay jayy 90,1500,4,2,2,50,1,VS Fighting
sww|rycroft,1500,4,2,2,50,1,VS Fighting
bryan papa,1500,4,2,2,50,1,NorCal Regionals
skz,1500,4,2,2,50,1,CPTA Last Chance Qualifier
rbn|duppsko,1500,12,5,7,41,2,Dreamhack Summer;Call of Ragnarok
bcw-gaara_sand,1500,4,2,2,50,1,SCR
bonehead,1500,4,2,2,50,1,Milan Games Week
wuming,1500,4,2,2,50,1,CPTA Last Chance Qualifier
iz juri,1500,4,2,2,50,1,CPTA Last Chance Qualifier
job gdx,1500,4,2,2,50,1,CEO
dranor,1500,4,2,2,50,1,First Attack
daddario,1500,4,2,2,50,1,Milan Games Week
fatso_523,1500,4,2,2,50,1,VS Fighting
srm mad king,1499,4,2,2,50,1,SCR
knix,1499,12,5,7,41,2,Dreamhack Summer;Dreamhack Winter
swk fbruce,1499,4,2,2,50,1,Combo Breaker
ffn kyoku,1499,4,2,2,50,1,SCR
でぇご,1499,4,2,2,50,1,Nine States
willy,1499,4,2,2,50,1,Taiwan
outlaw,1499,4,2,2,50,1,KO Fighting Game Festival
shogunn,1499,4,2,2,50,1,SCR
赵渭炯 小迷,1499,4,2,2,50,1,CPTA Shanghai
px|doomed,1499,2,1,1,50,1,True Challengers Costa Rica
dean of games,1499,4,2,2,50,1,Northwest Majors
デップー,1499,4,2,2,50,1,Nine States
salem akuma,1499,4,2,2,50,1,KO Fighting Game Festival
boahmad,1499,4,2,2,50,1,KO Fighting Game Festival
aag|baby brasil,1499,2,1,1,50,1,CPT Brazil
alafasy_23,1499,4,2,2,50,1,KO Fighting Game Festival
prk benji,1499,4,2,2,50,1,First Attack
wyseguy,1499,4,2,2,50,1,Combo Breaker
tierproblem,1499,4,2,2,50,1,Texas Showdown
jackson,1499,4,2,2,50,1,CPTA Last Chance Qualifier
blag,1499,4,2,2,50,1,VS Fighting
arson,1499,4,2,2,50,1,CEO
dchong,1499,8,4,4,50,2,NorCal Regionals;SCR
borralí,1499,4,2,2,50,1,First Attack
amaury,1499,4,2,2,50,1,First Attack
方思 ice,1499,4,2,2,50,1,CPTA Shanghai
thamer1977,1499,4,2,2,50,1,KO Fighting Game Festival
justrun,1499,4,2,2,50,1,Texas Showdown
unforunatefleshgolem,1499,4,2,2,50,1,Texas Showdown
usin,1499,4,2,2,50,1,CEO
nfgc|carnageprincess,1499,4,2,2,50,1,VS Fighting
geomonstaah,1499,4,2,2,50,1,Texas Showdown
leon lum,1499,4,2,2,50,1,FV Cup
profx,1499,4,2,2,50,1,VS Fighting
xdsc-knowledge,1499,4,2,2,50,1,TFC
p skelly,1499,4,2,2,50,1,CEO
ds|jamusan,1499,4,2,2,50,1,VS Fighting
havocvstheworld,1499,4,2,2,50,1,CEO
md calin,1499,4,2,2,50,1,Red Fight District
shockbeast,1499,4,2,2,50,1,SCR
ua|wholio,1499,4,2,2,50,1,Texas Showdown
allen hunt,1499,4,2,2,50,1,TFC
omegastriker,1499,4,2,2,50,1,Combo Breaker
nhem lee,1499,4,2,2,50,1,Texas Showdown
mr. shoushi,1499,4,2,2,50,1,Texas Showdown
scc|unw4nt3d,1499,4,2,2,50,1,VS Fighting
bryan,1499,4,2,2,50,1,FV Cup
spree,1499,4,2,2,50,1,Combo Breaker
firefist,1499,4,2,2,50,1,VS Fighting
platinum kid,1499,8,4,4,50,2,VS Fighting;EGX
flb|victor,1499,4,2,2,50,1,VS Fighting
sean why,1499,3,1,2,33,1,TFC
violent repent,1499,4,2,2,50,1,CEO
rs|ladnopoka,1499,4,2,2,50,1,Hypespotting
edgyjohnny,1499,4,2,2,50,1,Northwest Majors
黄洁 shermie（虾米）,1499,4,2,2,50,1,HK
dionis8534,1499,4,2,2,50,1,CEO
od|hollow,1498,4,2,2,50,1,First Attack
dm|burn notice,1498,4,2,2,50,1,NorCal Regionals
wh vicious,1498,4,2,2,50,1,Combo Breaker
raykay,1498,3,1,2,33,1,KSB 2015
nate fearless,1498,4,2,2,50,1,CEO
crazydog,1498,3,1,2,33,1,CPTA Last Chance Qualifier
moony blues,1498,4,2,2,50,1,Combo Breaker
@theb00st,1498,4,2,2,50,1,Combo Breaker
sa shank,1498,4,2,2,50,1,CEO
ナックル nakkuru,1498,4,2,2,50,1,Nine States
kenshiro,1498,4,2,2,50,1,Combo Breaker
豆腐 tofu,1498,4,2,2,50,1,Nine States
gvoice,1498,4,2,2,50,1,KO Fighting Game Festival
(setx) willcola,1498,4,2,2,50,1,Texas Showdown
bomsa,1498,4,2,2,50,1,KO Fighting Game Festival
greedychun,1498,4,2,2,50,1,Combo Breaker
fera,1498,4,2,2,50,1,NorCal Regionals
nsm fancyyancy,1498,4,2,2,50,1,CEO
ishotto,1498,8,4,4,50,2,Combo Breaker;CEO
vincent,1498,4,2,2,50,1,CPTA Shanghai
無刑,1498,4,2,2,50,1,Nine States
chenxin gouzi,1498,4,2,2,50,1,CPTA Shanghai
仮面の魔術師,1498,4,2,2,50,1,Nine States
もふもふ,1498,4,2,2,50,1,Nine States
big poe,1498,4,2,2,50,1,Texas Showdown
threecentipedes,1498,4,2,2,50,1,NorCal Regionals
google_deez,1498,4,2,2,50,1,CEO
venomkiller,1498,4,2,2,50,1,CPTA Last Chance Qualifier
ninja musik g,1498,4,2,2,50,1,CPTA KR
jkazuma,1498,4,2,2,50,1,KO Fighting Game Festival
dawgenhower,1498,4,2,2,50,1,Texas Showdown
jing,1498,4,2,2,50,1,CPTA Shanghai
khio,1498,4,2,2,50,1,SCR
icg redvelvet,1498,4,2,2,50,1,Texas Showdown
jayto,1498,4,2,2,50,1,Texas Showdown
blue kaizer,1498,4,2,2,50,1,KO Fighting Game Festival
chan shing chi xft_sonicbeta,1498,4,2,2,50,1,HK
johnnylamonte,1498,4,2,2,50,1,Texas Showdown
zhudongyu,1498,4,2,2,50,1,CPTA Shanghai
quaka,1498,7,3,4,42,2,EGX;Dreamhack Winter
fairlysadpanda,1498,4,2,2,50,1,Hypespotting
ink7,1498,6,3,3,50,1,CPTA KR
vs roy,1498,4,2,2,50,1,Combo Breaker
chemical ali,1498,4,2,2,50,1,CEO
misteranthropy,1498,4,2,2,50,1,NorCal Regionals
lord devil,1498,4,2,2,50,1,KO Fighting Game Festival
khadell,1498,4,2,2,50,1,CEO
gka soul below,1498,4,2,2,50,1,Combo Breaker
s1ngho,1498,4,2,2,50,1,VS Fighting
rinbo7,1498,4,2,2,50,1,CPTA KR
tkr_doukhi,1498,4,2,2,50,1,KO Fighting Game Festival
kwok sui tak barrytak,1498,4,2,2,50,1,HK
noodles,1498,4,2,2,50,1,VS Fighting
bsc|hadoshrooms,1498,8,4,4,50,2,Hypespotting;VS Fighting
gdlk.co|churro,1498,4,2,2,50,1,Northwest Majors
snx,1498,4,2,2,50,1,VS Fighting
wong tin pui shiro fans,1498,4,2,2,50,1,HK
ed|undeadjim,1498,4,2,2,50,1,VS Fighting
dm|willpower,1498,6,3,3,50,2,NorCal Regionals;EVO
sfo|tiger flowsion,1498,4,2,2,50,1,VS Fighting
suddenblackout,1498,4,2,2,50,1,NorCal Regionals
xdsc-knowledgereup,1498,4,2,2,50,1,CEO
ifd humbag,1498,4,2,2,50,1,Combo Breaker
schmoo,1498,4,2,2,50,1,Combo Breaker
sprint,1498,8,4,4,50,2,Hypespotting;VS Fighting
ck-vnz,1498,5,2,3,40,1,Saigon Cup
nick t.,1498,4,2,2,50,1,Combo Breaker
hydro,1498,4,2,2,50,1,NorCal Regionals
demonlos,1498,4,2,2,50,1,NorCal Regionals
lk,1498,4,2,2,50,1,Saigon Cup
林諾勤 kennklam,1498,4,2,2,50,1,HK
ash,1498,4,2,2,50,1,Hypespotting
shogun dynamite,1498,4,2,2,50,1,CEO
jthamind,1498,4,2,2,50,1,Combo Breaker
邬可夫 阿修,1498,2,1,1,50,1,HK
kingdomkey92,1498,4,2,2,50,1,SCR
raoul,1498,4,2,2,50,1,NorCal Regionals
onslaught,1498,4,2,2,50,1,NorCal Regionals
hero504,1498,4,2,2,50,1,Texas Showdown
misak,1498,4,2,2,50,1,Combo Breaker
ben ho,1498,4,2,2,50,1,Texas Showdown
sfo zxmx,1498,4,2,2,50,1,Hypespotting
sml|shinmael,1498,4,2,2,50,1,VS Fighting
leadman,1498,4,2,2,50,1,Combo Breaker
ttf|jamaal jackson,1498,4,2,2,50,1,SCR
masterninja,1498,4,2,2,50,1,Texas Showdown
rize|ind|mug|rdubstepper,1498,4,2,2,50,1,Hypespotting
battlefelde,1498,4,2,2,50,1,Combo Breaker
mn somemexicanguy,1498,4,2,2,50,1,Combo Breaker
crisium,1498,4,2,2,50,1,Texas Showdown
bloodyziff,1498,4,2,2,50,1,SCR
mikejay,1498,4,2,2,50,1,SCR
ssj hotdog,1498,4,2,2,50,1,CEO
summer xft_summer,1498,4,2,2,50,1,HK
norcal joe,1498,4,2,2,50,1,NorCal Regionals
bcw-carlos danger,1498,4,2,2,50,1,SCR
formerlyunknown,1498,4,2,2,50,1,TFC
kristougher,1498,4,2,2,50,1,TFC
maxoplata,1498,4,2,2,50,1,SCR
jlm,1498,4,2,2,50,1,Hypespotting
banto,1498,4,2,2,50,1,Combo Breaker
南哥的小戀人/陳二,1498,4,2,2,50,1,Taiwan
burger time,1498,4,2,2,50,1,Combo Breaker
rde|samurai drew,1498,4,2,2,50,1,Hypespotting
sa tempun,1498,4,2,2,50,1,CEO
surgingstorm,1498,4,2,2,50,1,TFC
revolver sagod,1498,4,2,2,50,1,NorCal Regionals
bcw_jmendes,1498,4,2,2,50,1,TFC
dm|katzu,1498,4,2,2,50,1,NorCal Regionals
小布,1498,4,2,2,50,1,Taiwan
tez,1498,4,2,2,50,1,Northwest Majors
dmt - mr. d,1498,4,2,2,50,1,SCR
alex turner,1498,4,2,2,50,1,CEO
panoptic,1498,4,2,2,50,1,SCR
vilmon,1498,4,2,2,50,1,Northwest Majors
bram,1498,4,2,2,50,1,FV Cup
anbu_mrfrayfray,1498,4,2,2,50,1,TFC
wang,1498,4,2,2,50,1,Ze Fighting Game Champion
ed|kyros,1498,11,5,6,45,3,Hypespotting;VS Fighting;EGX
daymo,1498,4,2,2,50,1,CEO
rs|ayjayirl,1498,4,2,2,50,1,Hypespotting
flan,1498,4,2,2,50,1,First Attack
crustiestwolf33,1498,4,2,2,50,1,Taiwan
rice_crackers,1498,4,2,2,50,1,NorCal Regionals
lele,1498,4,2,2,50,1,Taiwan
bringbackiceclimbers,1498,4,2,2,50,1,CEO
操查理,1498,4,2,2,50,1,Taiwan
twmsp,1498,4,2,2,50,1,Taiwan
aldenteoh,1498,4,2,2,50,1,FV Cup
mr|jetpackjohnny,1498,4,2,2,50,1,NorCal Regionals
jh maxninja,1498,4,2,2,50,1,CEO
ipg|dcb staticgorilla,1498,4,2,2,50,1,Northwest Majors
jet,1498,12,6,6,50,2,Dreamhack Summer;Dreamhack Winter
the steam co|bacardi,1498,4,2,2,50,1,First Attack
keane_hi,1498,4,2,2,50,1,FV Cup
kaara,1498,4,2,2,50,1,Ultra Hyakkishu Cup
final tick,1498,4,2,2,50,1,TFC
design,1498,4,2,2,50,1,CEO
zaybak,1498,4,2,2,50,1,Combo Breaker
omg itz andre,1498,4,2,2,50,1,Combo Breaker
negator,1498,4,2,2,50,1,Taiwan
sulabee,1498,4,2,2,50,1,Taiwan
linux,1498,4,2,2,50,1,Combo Breaker
sa projectsik,1498,4,2,2,50,1,CEO
sft|alexandro,1498,2,1,1,50,1,CPT Brazil
deja fait,1498,4,2,2,50,1,CEO
lin先生,1498,4,2,2,50,1,Taiwan
小宝,1498,4,2,2,50,1,Ze Fighting Game Champion
javy jitters,1498,4,2,2,50,1,First Attack
wmd|mom's spaghetti,1498,4,2,2,50,1,NorCal Regionals
oppoi,1498,3,1,2,33,1,Ultra Hyakkishu Cup
ep1cp33,1498,4,2,2,50,1,CEO
saltybetts,1498,4,2,2,50,1,Combo Breaker
eminent,1498,4,2,2,50,1,CEO
jnana,1498,4,2,2,50,1,Taiwan
sa karu,1498,4,2,2,50,1,CEO
brz rattosai,1498,4,2,2,50,1,First Attack
mk tux,1497,4,2,2,50,1,VS Fighting
jacky cannons,1497,4,2,2,50,1,Combo Breaker
keetro,1497,8,4,4,50,2,Combo Breaker;CEO
wagahai,1497,4,2,2,50,1,TFC
maromas mxl,1497,4,2,2,50,1,SCR
jaguar_murad,1497,4,2,2,50,1,KO Fighting Game Festival
ac riki-oh,1497,4,2,2,50,1,Northwest Majors
郑诚 lutak,1497,4,2,2,50,1,CPTA Shanghai
ed|noonez,1497,4,2,2,50,1,VS Fighting
taunt,1497,3,1,2,33,1,Cannes Winter Clash
okome man,1497,8,4,4,50,2,Nine States;Ultra Hyakkishu Cup
revolver dropsalot,1497,4,2,2,50,1,CEO
enfont pordu a easyman,1497,4,2,2,50,1,Red Fight District
noobiex,1497,4,2,2,50,1,Saigon Cup
raego,1497,4,2,2,50,1,Dreamhack Winter
daiki matsubara so,1497,4,2,2,50,1,HK
rob zfr,1497,8,4,4,50,2,VS Fighting;EGX
ultrabram,1497,5,2,3,40,1,Saigon Cup
801 mr gork,1496,8,4,4,50,2,NorCal Regionals;Northwest Majors
pag dragongod,1496,3,1,2,33,1,Summer Jam
kubisa,1496,4,2,2,50,1,VS Fighting
poncho the blue volcano,1496,3,1,2,33,1,SCR
阳光少年,1496,3,1,2,33,1,Ze Fighting Game Champion
op|sick bubblegum,1496,5,2,3,40,1,Dreamhack Winter
re:,1496,3,1,2,33,1,Ultra Hyakkishu Cup
mohamedo,1496,3,1,2,33,1,Ultra Hyakkishu Cup
pg|coach steve,1496,10,4,6,40,3,Summer Jam;SCR;Defend the North
なお,1495,3,1,2,33,1,KSB 2015
sd legend,1495,3,1,2,33,1,SCR
kage,1495,3,1,2,33,1,CPTA KR
hlm,1495,3,1,2,33,1,Red Fight District
cloud9,1495,1,0,1,0,1,EVO
kuroda,1495,3,1,2,33,1,Ultra Hyakkishu Cup
mdr,1495,3,1,2,33,1,Ultra Hyakkishu Cup
sfo brylarke,1495,9,4,5,44,2,EGX;Dreamhack Winter
スコア,1495,3,1,2,33,1,KSB 2015
latiamattner29,1495,3,1,2,33,1,Ze Fighting Game Champion
もづく,1495,3,1,2,33,1,KSB 2015
ugc hellfyre,1494,3,1,2,33,1,SCR
devil reapers jimmy,1494,3,1,2,33,1,Red Fight District
soa|caju,1494,3,1,2,33,1,CPT Brazil
rs|cobelcog,1494,10,4,6,40,3,Hypespotting;VS Fighting;EGX
shaunjs,1494,7,3,4,42,2,Hypespotting;VS Fighting
joker,1494,7,3,4,42,2,First Attack;Milan Games Week
leland,1494,3,1,2,33,1,CEO
dr. b,1494,1,0,1,0,1,EVO
koyasu,1494,3,1,2,33,1,Ultra Hyakkishu Cup
wtq8|jaber,1494,3,1,2,33,1,KO Fighting Game Festival
perplex,1494,3,1,2,33,1,Cannes Winter Clash
ymb 9 big boss,1494,3,1,2,33,1,Hypespotting
pie|sci,1494,1,0,1,0,1,Defend the North
dante dt,1494,5,2,3,40,1,CPTA Shanghai
cheng chun hung 天下布武,1493,3,1,2,33,1,HK
tc507|kakaroto,1493,3,1,2,33,1,True Challengers Costa Rica
koryu,1493,3,1,2,33,1,NorCal Regionals
ks|tali,1493,1,0,1,0,1,Defend the North
dojo_got_trees,1493,3,1,2,33,1,NorCal Regionals
franky,1493,3,1,2,33,1,SCR
tosfhq|general luke,1493,1,0,1,0,1,Canada Cup
yomi excited beast,1493,7,3,4,42,2,CEO;TFC
armageddon8,1493,3,1,2,33,1,NorCal Regionals
威哥,1493,3,1,2,33,1,Ze Fighting Game Champion
j8slim,1493,3,1,2,33,1,TFC
babaghanoush1985,1493,3,1,2,33,1,SCR
macabremonster,1493,3,1,2,33,1,SCR
mdz|emtpysys,1493,1,0,1,0,1,FFM-Rumble
ybk|shin,1493,3,1,2,33,1,Ultra Hyakkishu Cup
coldvoid,1493,3,1,2,33,1,Combo Breaker
theory fighter,1493,3,1,2,33,1,EGX
vx,1493,3,1,2,33,1,Milan Games Week
setx 199x survivor pro,1493,3,1,2,33,1,Texas Showdown
izumi kouta,1493,3,1,2,33,1,Ultra Hyakkishu Cup
tosfhq|jimmy fierce,1493,1,0,1,0,1,Canada Cup
rbn|bliredd,1493,3,1,2,33,1,Call of Ragnarok
chris tweten ctwtn,1493,3,1,2,33,1,CPTA Shanghai
streetmonkeys hekiat,1493,3,1,2,33,1,Red Fight District
oc 919,1493,3,1,2,33,1,TFC
pedram,1493,3,1,2,33,1,Call of Ragnarok
no-leaf_clover76,1493,3,1,2,33,1,CPTA KR
jorge arana,1493,3,1,2,33,1,Milan Games Week
chris nguyen,1493,3,1,2,33,1,SCR
theprince4d,1493,1,0,1,0,1,Canada Cup
ひかりん,1493,3,1,2,33,1,KSB 2015
775 ya0,1492,3,1,2,33,1,NorCal Regionals
cyberchink,1492,3,1,2,33,1,NorCal Regionals
jimmy89,1492,3,1,2,33,1,Milan Games Week
schiacci sempre,1492,3,1,2,33,1,Milan Games Week
rde|sddowns,1492,7,3,4,42,2,Hypespotting;VS Fighting
ldo,1492,3,1,2,33,1,NorCal Regionals
onetimehero,1492,3,1,2,33,1,NorCal Regionals
mdz ricky,1492,3,1,2,33,1,Red Fight District
ahbao,1492,1,0,1,0,1,HK
red_panda_0bjection,1492,3,1,2,33,1,TFC
张翔渝 freeman,1492,3,1,2,33,1,HK
tlc|saga,1492,1,0,1,0,1,EVO
dm|mr. tails,1492,3,1,2,33,1,NorCal Regionals
almond42,1492,3,1,2,33,1,CPTA KR
david copperfield,1492,3,1,2,33,1,Taiwan
white fang,1492,3,1,2,33,1,Ultra Hyakkishu Cup
ebomb,1492,7,3,4,42,2,Northwest Majors;SCR
xzalis,1492,3,1,2,33,1,CEO
susubabi,1492,3,1,2,33,1,Abuget Cup
tomarre,1492,3,1,2,33,1,SCR
きょく,1492,3,1,2,33,1,KSB 2015
tsc|ifc yipes,1492,1,0,1,0,1,Final Round
pine,1492,3,1,2,33,1,Saigon Cup
郭大喜,1492,3,1,2,33,1,Ze Fighting Game Champion
dm|soothsayer,1492,3,1,2,33,1,NorCal Regionals
yoshio,1492,3,1,2,33,1,Milan Games Week
big betty swalls,1492,3,1,2,33,1,Northwest Majors
money martinez,1492,3,1,2,33,1,Texas Showdown
baoice,1492,1,0,1,0,1,HK
al,1492,3,1,2,33,1,CPTA KR
shougai adashi-ku min,1492,3,1,2,33,1,Ultra Hyakkishu Cup
frank the tank,1492,3,1,2,33,1,TFC
tatsushoryu,1492,3,1,2,33,1,SCR
765p fizzykups,1492,3,1,2,33,1,CEO
gamachan,1492,3,1,2,33,1,EGX
jan,1492,3,1,2,33,1,CPTA Last Chance Qualifier
tiger uppercut,1492,3,1,2,33,1,Saigon Cup
dave o,1491,7,3,4,42,2,Northwest Majors;Combo Breaker
minde,1491,3,1,2,33,1,Taiwan
alkaline,1491,3,1,2,33,1,NorCal Regionals
chiu sung hong gexp,1491,3,1,2,33,1,HK
beastchan23,1491,3,1,2,33,1,Texas Showdown
fv tkc,1491,3,1,2,33,1,FV Cup
guggemamol,1491,3,1,2,33,1,Red Fight District
kenneth lai thunder 9,1491,3,1,2,33,1,HK
kisaran,1491,3,1,2,33,1,Ultra Hyakkishu Cup
cptmaumau,1491,3,1,2,33,1,CPTA KR
shredded manlet,1491,3,1,2,33,1,Hypespotting
the professional,1491,5,2,3,40,1,Texas Showdown
ne yooyoung,1491,3,1,2,33,1,Combo Breaker
jiji,1491,3,1,2,33,1,VS Fighting
krs t3p valiant,1491,3,1,2,33,1,CEO
drake von duke,1491,3,1,2,33,1,CEO
wahlau,1491,3,1,2,33,1,FV Cup
min,1491,1,0,1,0,1,Final Round
across,1491,3,1,2,33,1,Ultra Hyakkishu Cup
danilo,1491,3,1,2,33,1,Milan Games Week
rs ayjayirl,1491,3,1,2,33,1,EGX
jason liu satc1014,1491,3,1,2,33,1,HK
team seaslug,1491,11,5,6,45,3,NorCal Regionals;Texas Showdown;CEO
acidrock,1491,3,1,2,33,1,FV Cup
willis,1491,3,1,2,33,1,HK
sfo ghost,1491,3,1,2,33,1,EGX
lost boy,1491,3,1,2,33,1,Texas Showdown
陈桓,1491,3,1,2,33,1,Ze Fighting Game Champion
tekateka,1491,3,1,2,33,1,Ultra Hyakkishu Cup
honda tropical,1491,3,1,2,33,1,First Attack
ずん,1491,3,1,2,33,1,KSB 2015
jappa,1491,3,1,2,33,1,First Attack
sft|fabinho,1491,1,0,1,0,1,CPT Brazil
dunham,1491,3,1,2,33,1,TFC
haw seow,1491,7,3,4,42,2,FV Cup;CPTA Last Chance Qualifier
zzlnsanezz,1491,3,1,2,33,1,CPTA KR
peluco,1491,3,1,2,33,1,First Attack
gutter trash,1491,3,1,2,33,1,Northwest Majors
charisma,1491,3,1,2,33,1,Ultra Hyakkishu Cup
lai chun wai neverdiewai,1491,3,1,2,33,1,HK
徐健 xj,1491,3,1,2,33,1,CPTA Shanghai
眉山拳王1,1491,1,0,1,0,1,Ze Fighting Game Champion
パスタ3,1491,3,1,2,33,1,KSB 2015
bye,1491,3,1,2,33,1,VS Fighting
sfo|dragonman,1491,3,1,2,33,1,VS Fighting
inc rollynx,1491,3,1,2,33,1,CPTA Last Chance Qualifier
ctrl b,1491,3,1,2,33,1,Red Fight District
detroit coco,1491,3,1,2,33,1,Texas Showdown
cevo,1491,3,1,2,33,1,Red Fight District
みだれねこ,1491,3,1,2,33,1,KSB 2015
张灂曦,1490,3,1,2,33,1,Ze Fighting Game Champion
sfo|willo,1490,3,1,2,33,1,Hypespotting
john,1490,3,1,2,33,1,Milan Games Week
cenerebb,1490,3,1,2,33,1,Milan Games Week
rde oscar,1490,3,1,2,33,1,Hypespotting
leonlum,1490,3,1,2,33,1,CPTA Last Chance Qualifier
realvocalist,1490,3,1,2,33,1,CPTA KR
abelity,1490,3,1,2,33,1,FV Cup
dmひでぶ～,1490,3,1,2,33,1,Nine States
torimeshi,1490,3,1,2,33,1,Ultra Hyakkishu Cup
kontoru,1490,3,1,2,33,1,Saigon Cup
small tom 細tommy,1490,3,1,2,33,1,HK
nyc vega,1490,3,1,2,33,1,TFC
かいひも,1490,3,1,2,33,1,Nine States
moor,1490,5,2,3,40,1,Milan Games Week
juggernaughty,1490,3,1,2,33,1,NorCal Regionals
alistarr,1490,3,1,2,33,1,Hypespotting
キヌイト,1490,3,1,2,33,1,Nine States
madana pc,1490,3,1,2,33,1,CPTA KR
samzo,1490,3,1,2,33,1,Texas Showdown
kb8,1490,3,1,2,33,1,Taiwan
madchewie,1490,3,1,2,33,1,NorCal Regionals
lexblade,1490,3,1,2,33,1,CPTA Last Chance Qualifier
mba|ermok,1490,3,1,2,33,1,VS Fighting
tommy chiam,1490,3,1,2,33,1,FV Cup
直播弟,1490,3,1,2,33,1,Ze Fighting Game Champion
丫合,1490,3,1,2,33,1,Taiwan
sfo willo,1490,3,1,2,33,1,EGX
tsid n8theoreat,1490,3,1,2,33,1,SCR
rm|saltface,1490,1,0,1,0,1,Final Round
吴滨 marstv.cornetto,1490,3,1,2,33,1,CPTA Shanghai
mek,1490,3,1,2,33,1,Northwest Majors
fgc|bean,1490,6,2,4,33,2,South East Asia Major;Ultra Hyakkishu Cup
dianminion,1490,3,1,2,33,1,FV Cup
sfo broodoo,1490,7,3,4,42,2,Hypespotting;EGX
noriyasu,1490,3,1,2,33,1,Ultra Hyakkishu Cup
hishow rabbit,1490,3,1,2,33,1,Ultra Hyakkishu Cup
gd just joe,1490,3,1,2,33,1,SCR
winston chen,1490,3,1,2,33,1,Taiwan
masterwho,1490,3,1,2,33,1,Combo Breaker
iki,1490,8,3,5,37,1,Dreamhack Summer
pag|glitch,1490,1,0,1,0,1,Defend the North
daddy-sensei,1490,3,1,2,33,1,Red Fight District
gw|sketch,1490,19,9,10,47,5,CPTA KR;KSB 2015;FV Cup;Taiwan;Defend the North
apocaalypse,1490,7,3,4,42,2,NorCal Regionals;Northwest Majors
talkbow,1490,3,1,2,33,1,Taiwan
jewelman,1490,1,0,1,0,1,EVO
lueshi,1490,3,1,2,33,1,Northwest Majors
ardi,1490,3,1,2,33,1,Abuget Cup
maxima,1490,3,1,2,33,1,Taiwan
ralstaanley,1490,3,1,2,33,1,CEO
elliot heath,1489,3,1,2,33,1,CEO
sho thesolgoodguy,1489,3,1,2,33,1,Combo Breaker
zalk,1489,3,1,2,33,1,Taiwan
skullied,1489,3,1,2,33,1,NorCal Regionals
krisimbored,1489,3,1,2,33,1,Texas Showdown
qcb|klitschko,1489,1,0,1,0,1,Defend the North
papo,1489,3,1,2,33,1,CEO
oneaboveall ad,1489,3,1,2,33,1,Texas Showdown
具体哥,1489,3,1,2,33,1,Ze Fighting Game Champion
mattdaddy916,1489,3,1,2,33,1,NorCal Regionals
downbackbro,1489,3,1,2,33,1,VS Fighting
ceo,1489,3,1,2,33,1,Ze Fighting Game Champion
buktooth,1489,1,0,1,0,1,EVO
nb|souji,1489,1,0,1,0,1,EVO
rosso,1489,3,1,2,33,1,Call of Ragnarok
koh kok sun,1489,3,1,2,33,1,FV Cup
aag|pr3da,1489,3,1,2,33,1,CPT Brazil
wtq8|ramadan,1489,3,1,2,33,1,KO Fighting Game Festival
kindou,1489,1,0,1,0,1,Tokyo Game Show
rf,1489,3,1,2,33,1,KSB 2015
gootecks,1489,1,0,1,0,1,EVO
goldencen,1489,1,0,1,0,1,EVO
jmasters,1489,3,1,2,33,1,Hypespotting
clowd,1489,3,1,2,33,1,SCR
chewmandinga,1489,3,1,2,33,1,Hypespotting
smbf nebbiez,1489,3,1,2,33,1,EGX
sa ghost,1489,3,1,2,33,1,CEO
ed|wilksy15,1489,7,3,4,42,2,Hypespotting;VS Fighting
tom90957-tw,1489,3,1,2,33,1,Taiwan
ぬ。nu,1489,3,1,2,33,1,Nine States
cord krohn ahgama,1489,3,1,2,33,1,HK
moonflow,1489,3,1,2,33,1,Saigon Cup
kermit alexander,1489,7,3,4,42,2,Texas Showdown;Combo Breaker
ya3goob,1489,3,1,2,33,1,KO Fighting Game Festival
thezuluwarrior,1489,3,1,2,33,1,VS Fighting
harris yung kuchi82,1489,3,1,2,33,1,HK
spano,1489,3,1,2,33,1,Saigon Cup
cooki3monster,1489,1,0,1,0,1,EVO
volg,1489,3,1,2,33,1,CPTA KR
romfinite,1489,3,1,2,33,1,SCR
ks|cbrn|nighttwo,1489,3,1,2,33,1,NorCal Regionals
stiqman,1489,3,1,2,33,1,SCR
burnoutfighter,1489,3,1,2,33,1,CPTA Last Chance Qualifier
brasssmunkye,1489,3,1,2,33,1,NorCal Regionals
２４７,1489,3,1,2,33,1,Nine States
yo_snax,1489,5,2,3,40,1,SCR
tuna,1489,3,1,2,33,1,Ultra Hyakkishu Cup
a$ap rabbitos,1489,1,0,1,0,1,Combo Breaker
bklynexpress,1489,12,5,7,41,3,Northwest Majors;CEO;SCR
iplay|maruko,1489,1,0,1,0,1,FFM-Rumble
tss hbic,1489,3,1,2,33,1,Texas Showdown
tr mac,1489,4,1,3,25,2,FFM-Rumble;Red Fight District
吴浩群 gz维尼,1489,3,1,2,33,1,CPTA Shanghai
ペルシャ,1489,3,1,2,33,1,KSB 2015
color,1488,3,1,2,33,1,CPTA Shanghai
mr. sparkle,1488,3,1,2,33,1,NorCal Regionals
scavenger xiii,1488,3,1,2,33,1,Hypespotting
hmd1050,1488,3,1,2,33,1,Red Fight District
gameguys danny express,1488,3,1,2,33,1,Texas Showdown
muirtron,1488,3,1,2,33,1,Hypespotting
very good tanaka,1488,3,1,2,33,1,Ultra Hyakkishu Cup
ninjamatic,1488,3,1,2,33,1,NorCal Regionals
jgt1201,1488,3,1,2,33,1,Hypespotting
vapourzz i,1488,3,1,2,33,1,VS Fighting
dm|casual phil,1488,3,1,2,33,1,NorCal Regionals
tws|tws gibbo,1488,7,3,4,42,2,Hypespotting;VS Fighting
zachinabox,1488,3,1,2,33,1,Combo Breaker
maxipoo,1488,3,1,2,33,1,Texas Showdown
めろんそーだ meronn soda,1488,3,1,2,33,1,Nine States
misfitpenguin,1488,3,1,2,33,1,CEO
jonodori,1488,3,1,2,33,1,Combo Breaker
jen,1488,3,1,2,33,1,CPTA Last Chance Qualifier
dm|nothing man,1488,3,1,2,33,1,NorCal Regionals
lk sobat,1488,3,1,2,33,1,VS Fighting
jkd,1488,3,1,2,33,1,NorCal Regionals
chromo,1488,3,1,2,33,1,NorCal Regionals
aes|nolafrog,1488,7,3,4,42,2,Texas Showdown;CEO
lom|slim,1488,3,1,2,33,1,VS Fighting
foolycooly2,1488,3,1,2,33,1,Ultra Hyakkishu Cup
my mom says i'm pro,1488,3,1,2,33,1,NorCal Regionals
rmfluffy,1488,3,1,2,33,1,NorCal Regionals
dinasaur king,1488,3,1,2,33,1,Hypespotting
militarymind510,1488,3,1,2,33,1,NorCal Regionals
kevin lee,1488,3,1,2,33,1,FV Cup
coffee,1488,3,1,2,33,1,CPTA Last Chance Qualifier
bidoofshock,1488,3,1,2,33,1,SCR
rst mambo penguin,1488,3,1,2,33,1,Hypespotting
muratto,1488,3,1,2,33,1,NorCal Regionals
ymb9 dutchie,1488,3,1,2,33,1,Hypespotting
ne.pxg synapsse,1488,3,1,2,33,1,Combo Breaker
ambush,1488,3,1,2,33,1,NorCal Regionals
johnny xrd,1488,3,1,2,33,1,Combo Breaker
cltn sl1m,1488,3,1,2,33,1,CEO
郭嘉成 hksiushingshing,1488,3,1,2,33,1,HK
aho,1488,3,1,2,33,1,Abuget Cup
kit potato salad,1488,7,3,4,42,2,CEO;TFC
joutai,1488,3,1,2,33,1,NorCal Regionals
pie|poem,1488,4,1,3,25,2,Defend the North;Canada Cup
sp|teiga,1488,1,0,1,0,1,Defend the North
blaqacid,1488,3,1,2,33,1,Combo Breaker
drunkenbanana,1488,3,1,2,33,1,Northwest Majors
asunyan,1488,3,1,2,33,1,Ultra Hyakkishu Cup
phdeejay (no psn id),1488,3,1,2,33,1,CPTA KR
romora,1488,3,1,2,33,1,Northwest Majors
ug|djvest,1487,1,0,1,0,1,EVO
marn,1487,1,0,1,0,1,Saigon Cup
aron mike,1487,3,1,2,33,1,Texas Showdown
kokujin,1487,1,0,1,0,1,EVO
phuong,1487,3,1,2,33,1,Saigon Cup
shido_,1487,3,1,2,33,1,KO Fighting Game Festival
kamoshio,1487,1,0,1,0,1,EVO
daisuketensei,1487,3,1,2,33,1,Texas Showdown
soulash,1487,1,0,1,0,1,KO Fighting Game Festival
almulla,1487,3,1,2,33,1,KO Fighting Game Festival
huomaotv jiewa,1487,2,0,2,0,1,South East Asia Major
player32,1487,1,0,1,0,1,South East Asia Major
iigtrii,1487,3,1,2,33,1,KO Fighting Game Festival
xanoz,1487,3,1,2,33,1,CEO
guiseppe,1487,1,0,1,0,1,Combo Breaker
funnylookinwhat,1487,3,1,2,33,1,CEO
frs,1487,2,0,2,0,1,CPTA KR
kuraudokin,1487,3,1,2,33,1,Taiwan
seriphx,1487,3,1,2,33,1,TFC
angel,1487,3,1,2,33,1,Texas Showdown
tss cambam,1487,3,1,2,33,1,Texas Showdown
rs nutrient,1487,3,1,2,33,1,EGX
chris belman,1487,3,1,2,33,1,Texas Showdown
setx|dlowe,1487,3,1,2,33,1,Texas Showdown
rick masters,1487,3,1,2,33,1,TFC
phd zeal,1487,3,1,2,33,1,Northwest Majors
silg|stanick,1487,11,4,7,36,3,FV Cup;Saigon Cup;CPTA Last Chance Qualifier
fv|mark,1487,7,3,4,42,2,FV Cup;Saigon Cup
rchan,1487,3,1,2,33,1,CPTA Last Chance Qualifier
kingblack,1487,3,1,2,33,1,CEO
annoobilation,1487,3,1,2,33,1,Red Fight District
fullmetal-alex,1487,3,1,2,33,1,Northwest Majors
jmob,1487,3,1,2,33,1,CEO
cupcake panda,1487,3,1,2,33,1,Texas Showdown
bloodzure,1487,3,1,2,33,1,CEO
沈艺洵 dabaipang,1487,3,1,2,33,1,CPTA Shanghai
そらネ�,1487,1,0,1,0,1,Nine States
peter sauce,1487,3,1,2,33,1,Texas Showdown
pdx waifu mobile (goggles),1487,3,1,2,33,1,Northwest Majors
canjs|cxr|bionicfraud,1487,3,1,2,33,1,Northwest Majors
jun10r123,1487,3,1,2,33,1,CEO
daniel butterworth,1487,3,1,2,33,1,Nine States
rinda wan,1487,3,1,2,33,1,FV Cup
blackcus,1487,3,1,2,33,1,FV Cup
cuddles|fadc|nasty,1487,3,1,2,33,1,Northwest Majors
jblaze,1487,3,1,2,33,1,CEO
saturnize,1487,7,3,4,42,2,Northwest Majors;SCR
phs buster chen,1487,3,1,2,33,1,Texas Showdown
snoop,1487,3,1,2,33,1,CEO
srd|blahblah,1487,3,1,2,33,1,TFC
v.s. lorde gamer,1487,3,1,2,33,1,SCR
mlp triox,1487,3,1,2,33,1,SCR
siamawich,1487,3,1,2,33,1,CEO
lom|vegedow,1487,7,3,4,42,2,VS Fighting;EGX
kungfutreachery,1487,3,1,2,33,1,Texas Showdown
nb slimetime,1487,3,1,2,33,1,Combo Breaker
brz|dj basket,1487,3,1,2,33,1,First Attack
sfo|nargrull,1487,3,1,2,33,1,VS Fighting
on|gabo,1487,1,0,1,0,1,True Challengers Costa Rica
白莽 孤高的双子座英雄,1487,3,1,2,33,1,CPTA Shanghai
david alvarez,1487,3,1,2,33,1,SCR
kalbibeef,1487,3,1,2,33,1,SCR
lilman,1487,3,1,2,33,1,CEO
ch|nigma,1487,1,0,1,0,1,True Challengers Costa Rica
zoke16,1487,3,1,2,33,1,First Attack
sfhappyfeet,1487,3,1,2,33,1,CEO
陈俊宇 藏人,1487,3,1,2,33,1,HK
g. summer,1487,3,1,2,33,1,SCR
jarocka,1487,3,1,2,33,1,CEO
dark hokage,1487,3,1,2,33,1,CEO
plu,1487,3,1,2,33,1,SCR
sft|dark817,1487,1,0,1,0,1,CPT Brazil
tryken,1487,3,1,2,33,1,CEO
ltwins|xitao,1487,1,0,1,0,1,CPT Brazil
sft|jacare,1487,1,0,1,0,1,CPT Brazil
boti,1487,3,1,2,33,1,First Attack
4bidden,1487,3,1,2,33,1,First Attack
朱忠旻 ps手柄渣,1487,3,1,2,33,1,CPTA Shanghai
roukanken,1487,3,1,2,33,1,Hypespotting
the beav,1487,3,1,2,33,1,CEO
sol,1487,3,1,2,33,1,Hypespotting
king of the jews,1487,3,1,2,33,1,Hypespotting
sff|goshtin,1487,3,1,2,33,1,VS Fighting
pnd|i2 gaug3,1487,3,1,2,33,1,VS Fighting
jlc,1487,3,1,2,33,1,Hypespotting
cg_sonicboom,1487,3,1,2,33,1,Combo Breaker
rawpower,1487,3,1,2,33,1,Milan Games Week
bryanpro,1487,3,1,2,33,1,Milan Games Week
minoxxx,1487,3,1,2,33,1,Milan Games Week
zay,1487,3,1,2,33,1,CEO
kmc hurricane,1486,3,1,2,33,1,CEO
mba yingah,1486,3,1,2,33,1,Hypespotting
adan,1486,3,1,2,33,1,Milan Games Week
mba|spartan throne,1486,3,1,2,33,1,Hypespotting
2002 pt cruiser,1486,3,1,2,33,1,CEO
屠双奇 t mug,1486,3,1,2,33,1,CPTA Shanghai
bushido,1486,3,1,2,33,1,Milan Games Week
matashoo,1486,3,1,2,33,1,Hypespotting
laoshenjiang,1486,3,1,2,33,1,CPTA Shanghai
david cameron.gov,1486,3,1,2,33,1,Hypespotting
okira,1486,3,1,2,33,1,Combo Breaker
吕尔德 八神,1486,3,1,2,33,1,CPTA Shanghai
rde|wonder ham,1486,3,1,2,33,1,Hypespotting
萧说说 萧说说,1486,3,1,2,33,1,CPTA Shanghai
chau pui hing jeono,1486,3,1,2,33,1,HK
juniblaze xxx,1486,3,1,2,33,1,CEO
rde shiftingshadows,1486,3,1,2,33,1,Hypespotting
eruxiahou,1486,3,1,2,33,1,Hypespotting
sonny,1486,3,1,2,33,1,Milan Games Week
rs|simon “the truth” lau,1486,3,1,2,33,1,Hypespotting
rgt crazy blk dude,1486,3,1,2,33,1,Combo Breaker
marcher29,1486,3,1,2,33,1,VS Fighting
rs|ko|kiki,1486,3,1,2,33,1,Hypespotting
score,1486,3,1,2,33,1,Ultra Hyakkishu Cup
narudo,1486,3,1,2,33,1,Ultra Hyakkishu Cup
job mr. travis,1486,3,1,2,33,1,Combo Breaker
ushijima,1486,3,1,2,33,1,Ultra Hyakkishu Cup
mike cue,1486,3,1,2,33,1,CEO
vsf|justinxavier,1486,3,1,2,33,1,Hypespotting
ne miasma,1486,3,1,2,33,1,Combo Breaker
priestessos,1486,3,1,2,33,1,Hypespotting
reimalken,1486,3,1,2,33,1,Hypespotting
spawn,1486,3,1,2,33,1,First Attack
yk,1486,3,1,2,33,1,Ultra Hyakkishu Cup
bfl|popidge,1486,7,3,4,42,2,Hypespotting;VS Fighting
rgt murasaki,1486,3,1,2,33,1,Hypespotting
bitta89,1486,3,1,2,33,1,Milan Games Week
dr. z,1486,3,1,2,33,1,CEO
hacken law xft_hacken_jp,1486,3,1,2,33,1,HK
sacred,1486,3,1,2,33,1,Hypespotting
rbr anbu deadlyclaw,1486,3,1,2,33,1,CEO
flicky,1486,3,1,2,33,1,Hypespotting
666,1486,3,1,2,33,1,Ultra Hyakkishu Cup
smbf|cogs quora,1486,3,1,2,33,1,VS Fighting
raxory.pr,1486,3,1,2,33,1,First Attack
rs|mikenyan,1486,3,1,2,33,1,Hypespotting
ds|gutsy,1486,3,1,2,33,1,VS Fighting
uvg the professional,1486,3,1,2,33,1,CEO
ryutarou,1486,3,1,2,33,1,Ultra Hyakkishu Cup
knifelife,1486,3,1,2,33,1,CEO
sww|axythetaxi,1486,3,1,2,33,1,VS Fighting
sgc mwisk,1486,3,1,2,33,1,Combo Breaker
j fabulous,1486,3,1,2,33,1,Combo Breaker
notorious a.l.b,1486,3,1,2,33,1,VS Fighting
kenneth hernandez,1486,3,1,2,33,1,First Attack
zero_hour,1486,3,1,2,33,1,NorCal Regionals
firstnevermore,1486,3,1,2,33,1,NorCal Regionals
hardtymze,1486,3,1,2,33,1,NorCal Regionals
srm h0odless,1486,3,1,2,33,1,Combo Breaker
wizlife69,1486,3,1,2,33,1,First Attack
loseygosey,1486,3,1,2,33,1,CEO
chibichild,1486,3,1,2,33,1,Combo Breaker
m.a.d.e. gameover,1486,3,1,2,33,1,Combo Breaker
lfgc maul,1486,3,1,2,33,1,Combo Breaker
bcw-rapidrunx,1486,3,1,2,33,1,NorCal Regionals
sww|tearod,1486,3,1,2,33,1,VS Fighting
romeo,1486,3,1,2,33,1,NorCal Regionals
soupbase,1486,3,1,2,33,1,Combo Breaker
saor (ireland),1486,3,1,2,33,1,HK
tharimrattler,1486,3,1,2,33,1,NorCal Regionals
og|mastermikee21,1486,2,0,2,0,1,Defend the North
ilsenewton 19,1486,3,1,2,33,1,CPTA Shanghai
tani,1486,3,1,2,33,1,VS Fighting
groceryoutletjustin,1486,3,1,2,33,1,NorCal Regionals
xft_fire xft_fire,1486,3,1,2,33,1,HK
usfal|boony12,1486,3,1,2,33,1,VS Fighting
ryan-san,1486,3,1,2,33,1,CEO
kaynewesker,1486,3,1,2,33,1,NorCal Regionals
孙子隆 kimoji,1486,3,1,2,33,1,CPTA Shanghai
dragon ninja,1486,3,1,2,33,1,SCR
sww|crumpets,1486,3,1,2,33,1,VS Fighting
1atk.lxg.infrit,1486,3,1,2,33,1,SCR
lemoncrimes,1486,3,1,2,33,1,SCR
ig|legendario drak,1486,3,1,2,33,1,First Attack
tay soul,1486,3,1,2,33,1,NorCal Regionals
joffocakes,1486,3,1,2,33,1,Hypespotting
oenomaus,1486,3,1,2,33,1,VS Fighting
rde|porcupine,1486,3,1,2,33,1,Hypespotting
ddrsensation,1486,3,1,2,33,1,Combo Breaker
millz,1486,3,1,2,33,1,NorCal Regionals
徐云龙 shinxcloud,1486,3,1,2,33,1,CPTA Shanghai
prk|razor,1486,3,1,2,33,1,First Attack
onealsky,1486,3,1,2,33,1,CEO
hf|tang,1486,3,1,2,33,1,NorCal Regionals
nefarious al,1486,3,1,2,33,1,NorCal Regionals
s0n1c w0lf,1486,3,1,2,33,1,NorCal Regionals
isaac chan panda,1486,3,1,2,33,1,HK
hola bird,1486,3,1,2,33,1,Combo Breaker
uli,1486,3,1,2,33,1,Combo Breaker
wl chris king,1486,3,1,2,33,1,SCR
codeserial,1486,3,1,2,33,1,NorCal Regionals
reno,1486,3,1,2,33,1,SCR
jonnyslipsin,1486,3,1,2,33,1,Hypespotting
mba|revenge,1486,3,1,2,33,1,VS Fighting
paulkamezou,1486,3,1,2,33,1,SCR
gpl - tommy pickles,1486,3,1,2,33,1,NorCal Regionals
pigeon,1486,3,1,2,33,1,NorCal Regionals
msd xavi,1486,3,1,2,33,1,First Attack
tm,1486,3,1,2,33,1,CEO
lamune,1486,3,1,2,33,1,NorCal Regionals
morphtoxic,1486,3,1,2,33,1,CEO
kb-zey,1486,3,1,2,33,1,VS Fighting
eggplant,1486,3,1,2,33,1,CEO
vhs classics,1486,3,1,2,33,1,Combo Breaker
saito,1486,3,1,2,33,1,First Attack
ang3lit0pr,1486,3,1,2,33,1,First Attack
antman,1486,3,1,2,33,1,NorCal Regionals
tokles,1486,3,1,2,33,1,CEO
2rawkets,1486,3,1,2,33,1,SCR
swk kaker,1486,3,1,2,33,1,Combo Breaker
martin s,1486,3,1,2,33,1,SCR
blitzking109,1486,3,1,2,33,1,CEO
vs|hustle crowe,1486,3,1,2,33,1,VS Fighting
sd_watt,1486,3,1,2,33,1,NorCal Regionals
t-venom,1486,3,1,2,33,1,NorCal Regionals
wolfie,1486,3,1,2,33,1,Combo Breaker
fillossofherr,1486,3,1,2,33,1,SCR
ninjaspy,1486,3,1,2,33,1,Combo Breaker
finchomatic,1486,3,1,2,33,1,Combo Breaker
fibonacci,1486,3,1,2,33,1,Combo Breaker
mba|yingah,1486,3,1,2,33,1,VS Fighting
jaytag,1486,3,1,2,33,1,NorCal Regionals
elpr|tkd wolf,1486,3,1,2,33,1,First Attack
みやこ,1486,3,1,2,33,1,Nine States
mysticnamja,1486,3,1,2,33,1,SCR
daft,1486,3,1,2,33,1,NorCal Regionals
grubbs,1486,3,1,2,33,1,CEO
sir reginald,1486,3,1,2,33,1,NorCal Regionals
nfgc|moogle,1486,3,1,2,33,1,VS Fighting
itzspammy,1486,3,1,2,33,1,CEO
25 r3dgy,1486,3,1,2,33,1,SCR
とまとたいがー,1486,3,1,2,33,1,Nine States
shinra,1486,3,1,2,33,1,CEO
otaku strawberryball,1486,3,1,2,33,1,NorCal Regionals
ins dumbluck,1486,3,1,2,33,1,Texas Showdown
donsanity,1486,3,1,2,33,1,SCR
まいけるたん,1486,3,1,2,33,1,Nine States
crazed rice,1486,3,1,2,33,1,CEO
thoth,1486,3,1,2,33,1,SCR
aicalier,1486,3,1,2,33,1,CEO
el ben,1486,3,1,2,33,1,NorCal Regionals
dylan campbell dcampb,1486,3,1,2,33,1,CPTA Shanghai
funplayer3s,1486,3,1,2,33,1,NorCal Regionals
hellamindgames choi,1486,2,0,2,0,1,NorCal Regionals
nwm lueshi,1486,3,1,2,33,1,CEO
zer0islife,1486,3,1,2,33,1,Combo Breaker
2iq|dangerous person,1486,3,1,2,33,1,Texas Showdown
shogundo,1486,3,1,2,33,1,Northwest Majors
マスタング,1486,3,1,2,33,1,Nine States
gt tier3 wolf,1486,3,1,2,33,1,CEO
nigel lee,1486,3,1,2,33,1,FV Cup
silentnova,1486,3,1,2,33,1,TFC
天朝贵族,1486,3,1,2,33,1,Ze Fighting Game Champion
章毅骏 屠jo奇,1486,3,1,2,33,1,HK
taitsu,1486,3,1,2,33,1,FV Cup
ぢぢ@くろねこ,1486,3,1,2,33,1,Nine States
goodjazz,1486,3,1,2,33,1,CPTA Last Chance Qualifier
ch (invitation pending),1486,3,1,2,33,1,Ze Fighting Game Champion
suryan nair,1486,3,1,2,33,1,FV Cup
meo wei meo.w,1486,3,1,2,33,1,CPTA Shanghai
theblackhombre,1486,3,1,2,33,1,CEO
jamarvelous,1486,3,1,2,33,1,Combo Breaker
onilink,1486,3,1,2,33,1,Combo Breaker
夏伟 minaさん,1486,3,1,2,33,1,CPTA Shanghai
collusion spark,1486,3,1,2,33,1,Northwest Majors
gala tse dabugala,1486,3,1,2,33,1,HK
阿翰,1486,3,1,2,33,1,Ze Fighting Game Champion
宅桑,1486,3,1,2,33,1,Ze Fighting Game Champion
sam malone,1486,3,1,2,33,1,Combo Breaker
samblack,1486,3,1,2,33,1,Northwest Majors
すけっち,1486,3,1,2,33,1,Nine States
cpt.marvel,1486,3,1,2,33,1,Northwest Majors
no name 0_o,1486,3,1,2,33,1,Combo Breaker
mr.,1486,3,1,2,33,1,Northwest Majors
darealsteven,1486,3,1,2,33,1,Combo Breaker
azrul,1486,3,1,2,33,1,FV Cup
moduspwnens,1486,3,1,2,33,1,CEO
redninja,1486,3,1,2,33,1,TFC
lee ho lun the killer,1486,3,1,2,33,1,HK
serpent,1486,3,1,2,33,1,Northwest Majors
metal bender,1486,3,1,2,33,1,CEO
fgr ts|murarob,1486,3,1,2,33,1,First Attack
masapiyo,1486,3,1,2,33,1,Northwest Majors
greateacher,1486,3,1,2,33,1,FV Cup
fsh,1486,3,1,2,33,1,Hypespotting
马天健 ultrakiller,1486,3,1,2,33,1,CPTA Shanghai
s.i.r. straycrit,1486,3,1,2,33,1,Combo Breaker
dr rock,1486,3,1,2,33,1,FV Cup
shane,1486,3,1,2,33,1,CPTA Last Chance Qualifier
bigboss dayasha,1486,3,1,2,33,1,CEO
pianodensetsu,1486,3,1,2,33,1,CEO
よしかずさん。yoshikazu san,1486,3,1,2,33,1,Nine States
dr. atomic,1486,3,1,2,33,1,TFC
hectorputrid,1486,3,1,2,33,1,CEO
blue,1486,3,1,2,33,1,Taiwan
dojo_grandknight,1486,3,1,2,33,1,CEO
doctorstantz,1486,7,3,4,42,2,Combo Breaker;SCR
condit,1486,3,1,2,33,1,CEO
rm9,1486,3,1,2,33,1,Taiwan
#bajaboys fullbleed,1486,7,3,4,42,2,Northwest Majors;Combo Breaker
mikej,1486,3,1,2,33,1,CEO
eog rico,1486,3,1,2,33,1,TFC
kenny kenny,1486,3,1,2,33,1,HK
孟澤,1486,3,1,2,33,1,Taiwan
rey,1486,3,1,2,33,1,Combo Breaker
hold dat l,1486,3,1,2,33,1,TFC
zack gademark mohadi,1486,3,1,2,33,1,CEO
aimforthefeet,1486,3,1,2,33,1,TFC
fender,1486,3,1,2,33,1,CPTA KR
何文泉 中山泉仔,1486,3,1,2,33,1,HK
ojg benjamin,1486,3,1,2,33,1,Combo Breaker
anthony bluesy,1486,3,1,2,33,1,HK
chen陳振銘,1486,3,1,2,33,1,Taiwan
李博 b春,1486,3,1,2,33,1,HK
著名旅游玩家sky,1486,3,1,2,33,1,HK
jian hua,1486,3,1,2,33,1,Taiwan
くりぱぱ kuripapa,1486,3,1,2,33,1,Nine States
霧雨 kirisame,1486,3,1,2,33,1,Nine States
hadokenfieds,1486,3,1,2,33,1,Combo Breaker
jean,1486,3,1,2,33,1,Combo Breaker
rpd mcz alex smith,1486,3,1,2,33,1,CEO
rjd,1486,3,1,2,33,1,CEO
bryant chan bchan-hk47,1486,3,1,2,33,1,HK
清哥,1486,3,1,2,33,1,Taiwan
kaiser rose,1486,3,1,2,33,1,CEO
bosco bosmoko,1486,3,1,2,33,1,HK
nexon,1486,3,1,2,33,1,First Attack
水 mizu,1486,3,1,2,33,1,Nine States
gmd daydreamer,1486,3,1,2,33,1,Texas Showdown
taxto,1486,3,1,2,33,1,First Attack
setx - mugs,1486,3,1,2,33,1,Texas Showdown
beno,1486,3,1,2,33,1,Combo Breaker
園長,1486,3,1,2,33,1,Taiwan
yousef84,1486,3,1,2,33,1,KO Fighting Game Festival
phs slip n slide,1486,3,1,2,33,1,Texas Showdown
themanseries,1486,3,1,2,33,1,TFC
hua0915,1486,3,1,2,33,1,Taiwan
小捷,1486,3,1,2,33,1,Taiwan
wtq8|bo bader,1486,3,1,2,33,1,KO Fighting Game Festival
wong chun yin denesis,1486,3,1,2,33,1,HK
hii 5 ghost,1486,3,1,2,33,1,CEO
睡大/sleeplong,1486,3,1,2,33,1,Taiwan
allenk,1486,3,1,2,33,1,Taiwan
eltrouble,1486,3,1,2,33,1,Taiwan
nekoyuki,1486,3,1,2,33,1,CEO
ssquirtdirt,1486,3,1,2,33,1,CEO
du yong quan fslong,1486,3,1,2,33,1,HK
papatiwawa,1486,2,0,2,0,1,South East Asia Major
macto,1486,3,1,2,33,1,Texas Showdown
泰瑞鴿,1486,3,1,2,33,1,Taiwan
conmystro,1486,3,1,2,33,1,CEO
r-18 hand holding,1486,3,1,2,33,1,First Attack
gailim,1486,3,1,2,33,1,CEO
zelpher,1486,8,3,5,37,1,Dreamhack Summer
blakrevolver,1486,3,1,2,33,1,Texas Showdown
小鍾,1486,3,1,2,33,1,Taiwan
fullbring,1486,3,1,2,33,1,Texas Showdown
tony cha cha,1486,3,1,2,33,1,Taiwan
dna,1486,3,1,2,33,1,Taiwan
mto,1486,3,1,2,33,1,Combo Breaker
kung_fru,1486,3,1,2,33,1,Texas Showdown
mohammad_,1486,3,1,2,33,1,KO Fighting Game Festival
el maleman,1486,3,1,2,33,1,Texas Showdown
millertime(usa),1486,3,1,2,33,1,Taiwan
fdf|loco shoto,1486,3,1,2,33,1,Texas Showdown
sasuke,1486,3,1,2,33,1,Taiwan
epyon,1486,3,1,2,33,1,Texas Showdown
fujiq8,1486,3,1,2,33,1,KO Fighting Game Festival
samuraispirit,1486,3,1,2,33,1,KO Fighting Game Festival
kabukii,1486,3,1,2,33,1,Texas Showdown
belmont,1486,3,1,2,33,1,CEO
epic|narcissistic,1486,3,1,2,33,1,Texas Showdown
小龍包,1486,3,1,2,33,1,Taiwan
loop|webtroy,1486,3,1,2,33,1,Texas Showdown
shogun17,1486,3,1,2,33,1,Combo Breaker
duy,1486,3,1,2,33,1,Saigon Cup
e-town lord steezer,1486,3,1,2,33,1,Combo Breaker
2iq|discount marx,1486,3,1,2,33,1,Texas Showdown
482|jelly,1486,3,1,2,33,1,Texas Showdown
cuby,1486,2,0,2,0,1,Summer Jam
spencerjs,1486,3,1,2,33,1,Texas Showdown
島主,1486,3,1,2,33,1,Taiwan
ctrl rayray,1485,7,3,4,42,2,Texas Showdown;CEO
fruit,1485,7,1,6,14,2,Saigon Cup;Dreamhack Winter
章毅骏 阿骏,1485,3,1,2,33,1,CPTA Shanghai
exg rosiechan92,1485,3,1,2,33,1,CEO
winhow.jung,1485,3,1,2,33,1,Taiwan
mba|armdevil,1485,7,3,4,42,2,Hypespotting;VS Fighting
starkillershane,1485,3,1,2,33,1,VS Fighting
pag celestine,1485,3,1,2,33,1,CEO
daniel dillips,1485,7,3,4,42,2,VS Fighting;EGX
top hat,1485,3,1,2,33,1,Combo Breaker
rush digital,1485,3,1,2,33,1,CEO
pandorascrate,1485,3,1,2,33,1,SCR
jd,1485,7,3,4,42,2,VS Fighting;CPTA Last Chance Qualifier
soulless,1485,3,1,2,33,1,SCR
xft jin tai xft jin tai,1485,3,1,2,33,1,HK
tarezou,1485,6,2,4,33,2,KSB 2015;Ultra Hyakkishu Cup
jun-ichi11,1485,5,2,3,40,1,CEO
kuraudo,1485,3,1,2,33,1,TFC
f99|tim,1485,4,1,3,25,2,EVO;Taiwan
big marcus,1484,2,0,2,0,1,Combo Breaker
battery pack,1484,3,1,2,33,1,SCR
shakugan,1484,3,1,2,33,1,SCR
ed ma,1484,2,0,2,0,1,Canada Cup
ipt.dru,1484,2,0,2,0,1,Manila Cup
cameraman,1484,10,4,6,40,3,Abuget Cup;CPTA KR;Milan Games Week
pragmag,1484,3,1,2,33,1,SCR
ＭＡＳＴ,1484,2,0,2,0,1,KSB 2015
ipt.garret,1484,2,0,2,0,1,Manila Cup
confz,1484,10,4,6,40,3,VS Fighting;Red Fight District;Milan Games Week
nashi,1483,2,0,2,0,1,Ultra Hyakkishu Cup
c0ckman007,1483,4,1,3,25,1,Dreamhack Winter
tekei,1483,4,1,3,25,1,Dreamhack Winter
atrosh,1483,4,1,3,25,1,Dreamhack Winter
天津飯,1482,6,2,4,33,1,Nine States
cuddles,1482,2,0,2,0,1,CEO
itsther,1482,2,0,2,0,1,TFC
ddungemi43,1482,2,0,2,0,1,CPTA KR
bigdamaul,1482,10,4,6,40,3,Nine States;NorCal Regionals;CPTA KR
gingerv1k1ng,1482,4,1,3,25,1,Dreamhack Winter
street4game master ziane,1482,2,0,2,0,1,Red Fight District
vt mgt,1482,2,0,2,0,1,Red Fight District
james,1482,2,0,2,0,1,Manila Cup
g.y.r.o,1482,14,6,8,42,4,Nine States;South East Asia Major;FV Cup;Ultra Hyakkishu Cup
usami mushiko,1481,2,0,2,0,1,Ultra Hyakkishu Cup
ホルト horuto,1481,2,0,2,0,1,Nine States
sd|feist,1481,2,0,2,0,1,SCR
eg|chocoblanka,1481,12,4,8,33,5,CEO;EVO;Tokyo Game Show;SCR;Ultra Hyakkishu Cup
tsm|leffen,1481,2,0,2,0,1,Call of Ragnarok
hikarin,1481,2,0,2,0,1,Nine States
themulverine,1481,2,0,2,0,1,CPTA KR
陈冕 福州|史莱姆,1481,2,0,2,0,1,CPTA Shanghai
b0tes,1481,2,0,2,0,1,Combo Breaker
scc|lark0,1481,6,2,4,33,2,Hypespotting;VS Fighting
forward dash,1481,17,7,10,41,3,Dreamhack Summer;Red Fight District;Dreamhack Winter
138zod,1481,2,0,2,0,1,NorCal Regionals
flex in the city,1481,2,0,2,0,1,CEO
itsbrianlol,1481,2,0,2,0,1,SCR
ikatsui yarou,1481,2,0,2,0,1,Manila Cup
john a falcon,1481,2,0,2,0,1,TFC
domo,1480,6,2,4,33,1,CPTA Last Chance Qualifier
bcw greyskarr,1480,2,0,2,0,1,TFC
remonadonoghue3,1480,2,0,2,0,1,Ze Fighting Game Champion
asimulation,1480,2,0,2,0,1,NorCal Regionals
robbie q,1480,2,0,2,0,1,Hypespotting
kobra,1480,4,1,3,25,1,Dreamhack Winter
ぷりん,1480,2,0,2,0,1,KSB 2015
itsforeverkursed,1480,2,0,2,0,1,CPTA KR
drakefang,1480,2,0,2,0,1,CPTA KR
papz,1480,6,2,4,33,1,Dreamhack Summer
applemouse,1480,2,0,2,0,1,Taiwan
yuosham,1480,2,0,2,0,1,KO Fighting Game Festival
flb azizul,1480,2,0,2,0,1,EGX
remybleu,1480,2,0,2,0,1,Summer Jam
mx mad,1480,2,0,2,0,1,TFC
tal,1480,6,2,4,33,2,CEO;TFC
hame na geru shogun,1479,2,0,2,0,1,Ultra Hyakkishu Cup
ww|camizakof,1479,2,0,2,0,1,CPT Brazil
まーやー,1479,2,0,2,0,1,KSB 2015
べー,1479,2,0,2,0,1,KSB 2015
lior,1479,2,0,2,0,1,Cannes Winter Clash
initial kyouso,1479,2,0,2,0,1,Ultra Hyakkishu Cup
electribe,1479,2,0,2,0,1,Ultra Hyakkishu Cup
hf|inorite,1479,2,0,2,0,1,NorCal Regionals
akg jedisalazar,1479,2,0,2,0,1,SCR
shiro(xiao bai),1479,2,0,2,0,1,CPTA KR
mast,1479,2,0,2,0,1,Ultra Hyakkishu Cup
robert dunne saor,1479,2,0,2,0,1,HK
zemerick,1479,2,0,2,0,1,Ze Fighting Game Champion
badi lootion,1479,2,0,2,0,1,Call of Ragnarok
島唄,1479,2,0,2,0,1,KSB 2015
peatdefeat,1479,4,1,3,25,1,Dreamhack Winter
杰克逊,1479,2,0,2,0,1,Ze Fighting Game Champion
streetmonkeys gotthemojo,1479,2,0,2,0,1,Red Fight District
sww|phoenix,1479,6,2,4,33,2,Hypespotting;VS Fighting
石頭,1479,2,0,2,0,1,Taiwan
space problems,1479,2,0,2,0,1,Hypespotting
lyhs,1479,8,3,5,37,1,Dreamhack Summer
lexu,1479,2,0,2,0,1,Hypespotting
vidacarstensen,1479,2,0,2,0,1,Ze Fighting Game Champion
chris gillon,1479,2,0,2,0,1,Hypespotting
vsl sizzla971,1479,2,0,2,0,1,Ze Fighting Game Champion
lieselottetietje,1479,2,0,2,0,1,Ze Fighting Game Champion
鍾竹軒/hsuan,1478,2,0,2,0,1,Taiwan
vgftaylor,1478,2,0,2,0,1,Northwest Majors
heidibardon,1478,2,0,2,0,1,Ze Fighting Game Champion
raj obee,1478,2,0,2,0,1,Summer Jam
xxstealthsneakxx,1478,4,1,3,25,1,CEO
rd/mr.karate,1478,2,0,2,0,1,Northwest Majors
kendofox,1478,2,0,2,0,1,Taiwan
the leoholic,1478,2,0,2,0,1,Red Fight District
shazli,1478,2,0,2,0,1,FV Cup
hootington,1478,2,0,2,0,1,Northwest Majors
eunbeen,1478,2,0,2,0,1,Call of Ragnarok
teddy xft_teddybear,1478,2,0,2,0,1,HK
wong wai tak steve wong,1478,4,1,3,25,1,HK
unggul,1478,2,0,2,0,1,Abuget Cup
jns,1478,9,3,6,33,2,Dreamhack Summer;Dreamhack Winter
parable greg,1478,6,2,4,33,2,Hypespotting;Red Fight District
oni.,1478,2,0,2,0,1,Ultra Hyakkishu Cup
dav0s,1478,2,0,2,0,1,CPTA KR
ex2 roy munson,1478,2,0,2,0,1,Hypespotting
moto,1478,2,0,2,0,1,Ultra Hyakkishu Cup
accurate,1478,2,0,2,0,1,NorCal Regionals
pompom,1478,2,0,2,0,1,Taiwan
kerick,1478,2,0,2,0,1,Taiwan
sanjo,1478,2,0,2,0,1,KSB 2015
dmt loki kky,1478,2,0,2,0,1,SCR
mr.magiclove,1478,4,1,3,25,1,Dreamhack Winter
194 pedro,1477,4,1,3,25,1,Dreamhack Winter
unsu,1477,2,0,2,0,1,Ultra Hyakkishu Cup
zenny,1477,2,0,2,0,1,Ultra Hyakkishu Cup
cfc|joão jotão,1477,4,1,3,25,1,Dreamhack Winter
mob slim,1477,2,0,2,0,1,Summer Jam
snaketits,1477,2,0,2,0,1,SCR
jigsaw,1477,2,0,2,0,1,NorCal Regionals
ngamer3k,1477,6,2,4,33,2,NorCal Regionals;Combo Breaker
sean-go,1477,2,0,2,0,1,NorCal Regionals
mathlete,1477,2,0,2,0,1,NorCal Regionals
ギャズ,1477,2,0,2,0,1,KSB 2015
namcore,1477,4,1,3,25,1,Dreamhack Winter
zeusx,1477,2,0,2,0,1,KO Fighting Game Festival
snow cone,1477,2,0,2,0,1,NorCal Regionals
dragonglove,1477,2,0,2,0,1,Northwest Majors
jeppa~,1477,6,2,4,33,2,KSB 2015;Ultra Hyakkishu Cup
team.veggey bliredd,1477,8,3,5,37,1,Dreamhack Summer
jonathan swee,1477,2,0,2,0,1,FV Cup
vsf justin,1477,2,0,2,0,1,EGX
ilovepjw,1477,2,0,2,0,1,CPTA KR
gearbox63,1476,2,0,2,0,1,NorCal Regionals
hells w1nd,1476,2,0,2,0,1,EGX
doc,1476,2,0,2,0,1,Northwest Majors
unclesatan,1476,2,0,2,0,1,Northwest Majors
artemis,1476,2,0,2,0,1,Northwest Majors
visual badmuts24,1476,2,0,2,0,1,Red Fight District
slappytheninja,1476,2,0,2,0,1,Northwest Majors
a4|andre,1476,2,0,2,0,1,Hypespotting
joe young,1476,2,0,2,0,1,Northwest Majors
金デヴ,1476,2,0,2,0,1,KSB 2015
jafar,1476,2,0,2,0,1,FV Cup
badguy,1476,2,0,2,0,1,Northwest Majors
agoat,1476,2,0,2,0,1,CEO
citizen,1476,2,0,2,0,1,EGX
madvillain,1476,2,0,2,0,1,Hypespotting
カリスマ,1476,2,0,2,0,1,KSB 2015
bobcustomgamer,1476,2,0,2,0,1,CEO
derick s,1476,2,0,2,0,1,Northwest Majors
モッツェルおじさん,1476,2,0,2,0,1,KSB 2015
scar,1476,2,0,2,0,1,NorCal Regionals
lemon pie,1476,2,0,2,0,1,SCR
pain,1476,2,0,2,0,1,KO Fighting Game Festival
vs tss paladin,1476,2,0,2,0,1,Hypespotting
juantonimobay,1476,2,0,2,0,1,NorCal Regionals
thunderlips,1476,2,0,2,0,1,Hypespotting
the3rdchild,1476,2,0,2,0,1,Hypespotting
marcoflight,1476,2,0,2,0,1,Milan Games Week
meisai ningyo,1476,2,0,2,0,1,Ultra Hyakkishu Cup
hagen,1476,2,0,2,0,1,Hypespotting
林帆 lingfan500,1476,2,0,2,0,1,CPTA Shanghai
neogaf shackzam,1476,2,0,2,0,1,Combo Breaker
shonk,1476,4,1,3,25,1,Dreamhack Winter
mrbungle,1476,6,2,4,33,2,Hypespotting;VS Fighting
beastbamba,1476,2,0,2,0,1,NorCal Regionals
bk9999,1476,2,0,2,0,1,CPTA Last Chance Qualifier
gameguys nero,1476,2,0,2,0,1,Texas Showdown
newbtrait,1476,2,0,2,0,1,NorCal Regionals
dion,1476,2,0,2,0,1,Abuget Cup
niceblock skenming,1476,6,2,4,33,1,HK
sfo|tscooler,1476,2,0,2,0,1,Hypespotting
senseisoul,1476,2,0,2,0,1,Hypespotting
jiraiya kurokaze,1476,2,0,2,0,1,Combo Breaker
hanamaruki,1476,2,0,2,0,1,Ultra Hyakkishu Cup
kinetic semiij,1476,2,0,2,0,1,CEO
chanson,1476,2,0,2,0,1,Ultra Hyakkishu Cup
skunk,1476,2,0,2,0,1,Ultra Hyakkishu Cup
hame-tamu,1476,2,0,2,0,1,Ultra Hyakkishu Cup
mizoguchi akikimi,1476,2,0,2,0,1,Ultra Hyakkishu Cup
macfaltine,1476,2,0,2,0,1,NorCal Regionals
gilky,1476,2,0,2,0,1,Combo Breaker
kenmike,1476,2,0,2,0,1,Abuget Cup
flat,1476,2,0,2,0,1,Ultra Hyakkishu Cup
junkohawley 19,1476,2,0,2,0,1,CPTA Shanghai
metaldb,1475,2,0,2,0,1,First Attack
near,1475,2,0,2,0,1,VS Fighting
bluebomber,1475,2,0,2,0,1,NorCal Regionals
rocketsmith,1475,2,0,2,0,1,CEO
rm kites,1475,2,0,2,0,1,CEO
happyton,1475,2,0,2,0,1,VS Fighting
choi chak choi chak gs base 10/hr,1475,2,0,2,0,1,HK
black2dafuturez,1475,2,0,2,0,1,VS Fighting
joel bowl,1475,2,0,2,0,1,Hypespotting
yeison,1475,2,0,2,0,1,First Attack
vexatiousidler,1475,2,0,2,0,1,Hypespotting
mr wolf,1475,2,0,2,0,1,Milan Games Week
skarfelt,1475,2,0,2,0,1,VS Fighting
silent hero,1475,2,0,2,0,1,TFC
butts mckenzie,1475,2,0,2,0,1,CEO
jctustin,1475,2,0,2,0,1,SCR
emmcub3d,1475,2,0,2,0,1,CEO
frogboat,1475,2,0,2,0,1,CEO
waffle slapper,1475,2,0,2,0,1,SCR
sbh|intehweeds,1475,2,0,2,0,1,CEO
urban shakedown,1475,2,0,2,0,1,SCR
holding,1475,2,0,2,0,1,SCR
ganz_76,1475,2,0,2,0,1,Milan Games Week
kit sbk,1475,2,0,2,0,1,SCR
r-gonaut,1475,2,0,2,0,1,SCR
ottokbron,1475,2,0,2,0,1,SCR
grasshoppa,1475,2,0,2,0,1,Combo Breaker
lord lorenz,1475,2,0,2,0,1,Milan Games Week
dianpao,1475,2,0,2,0,1,CPTA Shanghai
styxtbm,1475,2,0,2,0,1,Texas Showdown
gungnir,1475,2,0,2,0,1,TFC
tss brother joshua,1475,2,0,2,0,1,Texas Showdown
l.grinta,1475,6,2,4,33,2,NorCal Regionals;SCR
ivanpants,1475,4,1,3,25,1,Texas Showdown
plats,1475,2,0,2,0,1,VS Fighting
ut mr gork,1475,2,0,2,0,1,CEO
gatoradmiral,1475,2,0,2,0,1,SCR
goku,1475,2,0,2,0,1,First Attack
pureevilj,1475,2,0,2,0,1,Combo Breaker
tof,1475,2,0,2,0,1,SCR
urbanexpression,1475,2,0,2,0,1,SCR
lilloco562,1475,2,0,2,0,1,SCR
gentle cam,1475,2,0,2,0,1,CEO
rm narwhal,1475,2,0,2,0,1,CEO
zutroi,1475,2,0,2,0,1,Milan Games Week
jeebius,1475,2,0,2,0,1,VS Fighting
pewchee,1475,2,0,2,0,1,CEO
clxjames,1475,2,0,2,0,1,CEO
solda,1475,2,0,2,0,1,Milan Games Week
kenneth,1475,2,0,2,0,1,FV Cup
lf|luoji - fenru,1475,2,0,2,0,1,NorCal Regionals
jed,1475,2,0,2,0,1,SCR
caderax,1475,2,0,2,0,1,NorCal Regionals
bon weiu,1475,2,0,2,0,1,FV Cup
rese|goldenbiscuit,1475,2,0,2,0,1,TFC
thariddler,1475,2,0,2,0,1,CEO
s-blade,1475,2,0,2,0,1,Northwest Majors
pmp revostylez,1475,2,0,2,0,1,First Attack
s̶c̶u̶b̶a̶s̶t̶e̶v̶e̶2̶5̶3̶ ̶-̶ ̶w,1475,2,0,2,0,1,Northwest Majors
hotsoup,1475,2,0,2,0,1,Combo Breaker
zeal,1475,2,0,2,0,1,FV Cup
benteezy,1475,2,0,2,0,1,CEO
freddie m.,1475,2,0,2,0,1,CEO
lorenzo pieracci,1475,2,0,2,0,1,Milan Games Week
fv edwin,1475,2,0,2,0,1,FV Cup
30f|nagai,1475,2,0,2,0,1,Northwest Majors
nicoy tiengo,1475,2,0,2,0,1,Milan Games Week
berri,1475,2,0,2,0,1,Milan Games Week
蔡钦 烈火麦当劳,1475,2,0,2,0,1,CPTA Shanghai
oc,1475,2,0,2,0,1,Ze Fighting Game Champion
gi_vantinel,1475,2,0,2,0,1,CEO
dgskater,1475,2,0,2,0,1,CEO
guro_loli,1475,2,0,2,0,1,Northwest Majors
pan,1475,2,0,2,0,1,Milan Games Week
nico,1475,2,0,2,0,1,Milan Games Week
og|lil evil,1475,6,2,4,33,2,CEO;Defend the North
uptempo87,1475,2,0,2,0,1,CEO
古奇 古奇,1475,2,0,2,0,1,CPTA Shanghai
mr traumallama,1475,2,0,2,0,1,CEO
sinical,1475,2,0,2,0,1,Red Fight District
sater_s1,1475,2,0,2,0,1,Milan Games Week
陈智聪 坑头仔,1475,2,0,2,0,1,HK
hawt salsa,1475,2,0,2,0,1,Northwest Majors
dllinftl,1475,2,0,2,0,1,CEO
spg squalayyy,1475,2,0,2,0,1,CEO
bfl|mowatman,1475,6,2,4,33,2,Hypespotting;VS Fighting
ちーたん,1475,6,2,4,33,1,Nine States
vsf jinty,1475,2,0,2,0,1,EGX
other scott,1475,2,0,2,0,1,CEO
matune,1475,2,0,2,0,1,CPTA KR
陆祁仁 johnny,1475,2,0,2,0,1,CPTA Shanghai
jtd,1475,2,0,2,0,1,Texas Showdown
たいがー,1475,2,0,2,0,1,KSB 2015
pattheflip,1475,2,0,2,0,1,CEO
usps mailmanimp,1475,2,0,2,0,1,Texas Showdown
me shane,1475,2,0,2,0,1,CPTA Last Chance Qualifier
prdrakwolf,1475,2,0,2,0,1,First Attack
mdzor,1475,2,0,2,0,1,Saigon Cup
お花畑,1475,2,0,2,0,1,Nine States
えにてょ,1475,2,0,2,0,1,Nine States
japf,1475,4,1,3,25,1,Dreamhack Winter
springwood slasher,1475,2,0,2,0,1,Combo Breaker
merlock,1475,2,0,2,0,1,Combo Breaker
hnh rs huggybear,1475,2,0,2,0,1,CEO
rocketgruntmark,1475,2,0,2,0,1,Texas Showdown
talal eg,1475,2,0,2,0,1,KO Fighting Game Festival
alex-23,1475,2,0,2,0,1,Texas Showdown
bader almahmeed,1475,2,0,2,0,1,KO Fighting Game Festival
avernaus,1475,2,0,2,0,1,KO Fighting Game Festival
second_son_5ald,1475,2,0,2,0,1,KO Fighting Game Festival
batman,1475,2,0,2,0,1,Texas Showdown
benji v.,1475,2,0,2,0,1,CEO
satc1014,1475,2,0,2,0,1,Taiwan
abodora,1475,2,0,2,0,1,KO Fighting Game Festival
rbr|ecchi mane,1475,2,0,2,0,1,Texas Showdown
ed|mantis,1474,2,0,2,0,1,VS Fighting
iyokuu,1474,2,0,2,0,1,Texas Showdown
nick rb,1474,2,0,2,0,1,Texas Showdown
bo_aseel,1474,2,0,2,0,1,KO Fighting Game Festival
tata chan tata,1474,2,0,2,0,1,HK
偉智/wedi,1474,2,0,2,0,1,Taiwan
sm gill,1474,2,0,2,0,1,Texas Showdown
7ussein_alsalmam,1474,2,0,2,0,1,KO Fighting Game Festival
cecil,1474,2,0,2,0,1,Texas Showdown
demitri,1474,2,0,2,0,1,Texas Showdown
vetash32,1474,2,0,2,0,1,Taiwan
ali_ahli,1474,2,0,2,0,1,KO Fighting Game Festival
ghostshock,1474,2,0,2,0,1,Texas Showdown
lupasan,1474,2,0,2,0,1,CEO
fems,1474,2,0,2,0,1,CEO
hedgiex,1474,2,0,2,0,1,CEO
swoopcoupe,1474,2,0,2,0,1,Texas Showdown
hamad_ahli,1474,2,0,2,0,1,KO Fighting Game Festival
king koopa,1474,6,2,4,33,2,Texas Showdown;CEO
xiao_zhu(france),1474,2,0,2,0,1,Taiwan
the american dream,1474,2,0,2,0,1,Texas Showdown
wtq8|ibraheem,1474,2,0,2,0,1,KO Fighting Game Festival
手把老桑,1474,2,0,2,0,1,Taiwan
aldy,1474,2,0,2,0,1,Abuget Cup
shadowofmath,1474,2,0,2,0,1,KO Fighting Game Festival
fickle platypus,1474,2,0,2,0,1,Texas Showdown
ins aj tucker,1474,2,0,2,0,1,Texas Showdown
hke|toyz(hong kong),1474,2,0,2,0,1,Taiwan
s.i.r. dinky,1474,2,0,2,0,1,Combo Breaker
sman,1474,2,0,2,0,1,Taiwan
kayto_aa,1474,2,0,2,0,1,KO Fighting Game Festival
three6d,1474,2,0,2,0,1,Texas Showdown
betterbryan,1474,2,0,2,0,1,Combo Breaker
aski,1474,2,0,2,0,1,Taiwan
格雷特,1474,2,0,2,0,1,Taiwan
keth,1474,2,0,2,0,1,CEO
faisalalmutairi,1474,2,0,2,0,1,KO Fighting Game Festival
reco子親愛的,1474,2,0,2,0,1,Taiwan
吉米,1474,2,0,2,0,1,Taiwan
botb mr.v,1474,2,0,2,0,1,Texas Showdown
failakawi,1474,2,0,2,0,1,KO Fighting Game Festival
feo grande,1474,2,0,2,0,1,CEO
the demonofmist,1474,2,0,2,0,1,CEO
あかり,1474,2,0,2,0,1,KSB 2015
osama_kun,1474,2,0,2,0,1,KO Fighting Game Festival
da doomsday,1474,2,0,2,0,1,Texas Showdown
ohdomai,1474,2,0,2,0,1,Taiwan
mortal_comebax,1474,2,0,2,0,1,KO Fighting Game Festival
ミゾテル,1474,2,0,2,0,1,KSB 2015
q8tyloco,1474,2,0,2,0,1,KO Fighting Game Festival
frootloop,1474,2,0,2,0,1,Combo Breaker
nopo shrub treks,1474,4,1,3,25,1,CEO
dmv makoto,1474,2,0,2,0,1,CEO
xmen007(hong kong),1474,2,0,2,0,1,Taiwan
様式美,1474,2,0,2,0,1,KSB 2015
peterson,1474,2,0,2,0,1,CEO
mba spartan throne,1474,2,0,2,0,1,EGX
koifishing,1474,2,0,2,0,1,Texas Showdown
sennette,1474,2,0,2,0,1,Saigon Cup
jebus,1474,2,0,2,0,1,Texas Showdown
metalqueersolid,1474,2,0,2,0,1,EGX
gaumin,1474,2,0,2,0,1,Saigon Cup
kilink/kk,1474,2,0,2,0,1,Taiwan
dry captain ook,1474,2,0,2,0,1,EGX
kec|sl burnout,1474,2,0,2,0,1,CPTA KR
pez man 81,1474,2,0,2,0,1,Combo Breaker
rut jabikuta,1474,2,0,2,0,1,CEO
twiggyflacko,1474,2,0,2,0,1,CEO
ss king jae,1474,2,0,2,0,1,EGX
spiritzero,1474,2,0,2,0,1,CPTA KR
娃娃,1474,2,0,2,0,1,Taiwan
mrgrreatness,1474,2,0,2,0,1,CEO
steve791,1474,2,0,2,0,1,CPTA KR
gg|alioufe,1474,2,0,2,0,1,Saigon Cup
troja,1474,2,0,2,0,1,Texas Showdown
feedthehead,1474,2,0,2,0,1,CEO
ferny,1474,2,0,2,0,1,CEO
adil g,1474,2,0,2,0,1,CEO
legato974,1474,2,0,2,0,1,CPTA KR
內子宮崎葵,1474,2,0,2,0,1,Taiwan
pag vgcj maestro,1474,2,0,2,0,1,CEO
sisf,1474,2,0,2,0,1,Combo Breaker
aiku,1474,2,0,2,0,1,CPTA KR
餃子,1474,2,0,2,0,1,Taiwan
svr ascender,1474,2,0,2,0,1,CEO
srkuw|future trunks,1474,2,0,2,0,1,Northwest Majors
reco,1474,2,0,2,0,1,Taiwan
男鴿,1474,2,0,2,0,1,Taiwan
jackiechanningtatum,1474,2,0,2,0,1,Saigon Cup
takuyasugi,1474,2,0,2,0,1,Texas Showdown
ジュリカス jurikasu,1474,2,0,2,0,1,Nine States
quang,1474,2,0,2,0,1,Saigon Cup
のび太,1474,2,0,2,0,1,Nine States
obake,1474,2,0,2,0,1,Red Fight District
welcome to you're doom!,1474,2,0,2,0,1,Northwest Majors
fake hd,1474,2,0,2,0,1,Taiwan
down right fierce,1474,2,0,2,0,1,CEO
schmidt,1474,2,0,2,0,1,CEO
ta|agent ecks,1474,2,0,2,0,1,Texas Showdown
么么小吉吉 么么小吉吉,1474,2,0,2,0,1,CPTA Shanghai
tony tsui gummy2015,1474,2,0,2,0,1,HK
あうぇ４ ｈｇｓｄが,1474,2,0,2,0,1,HK
yanyan(japan),1474,2,0,2,0,1,Taiwan
duc nguyen,1474,2,0,2,0,1,Saigon Cup
vt kirat,1474,2,0,2,0,1,Red Fight District
liquid chillin,1474,2,0,2,0,1,CEO
pote,1474,2,0,2,0,1,Northwest Majors
ao3,1474,2,0,2,0,1,FV Cup
leafyboy12,1474,2,0,2,0,1,CEO
shahril harith,1474,2,0,2,0,1,FV Cup
ake nupa,1474,2,0,2,0,1,Northwest Majors
mdz kampfkeks667,1474,2,0,2,0,1,Red Fight District
vinness ho,1474,2,0,2,0,1,FV Cup
andywuzc,1474,2,0,2,0,1,Taiwan
kenneth hystericyuu,1474,2,0,2,0,1,HK
2iq|mothman,1474,2,0,2,0,1,Texas Showdown
niceguyngo,1474,2,0,2,0,1,Northwest Majors
jackson deruloo,1474,2,0,2,0,1,Northwest Majors
mio bison,1474,2,0,2,0,1,CEO
tam,1474,2,0,2,0,1,Saigon Cup
hashshashiyyin,1474,2,0,2,0,1,Red Fight District
皮皮/pipi,1474,2,0,2,0,1,Taiwan
髭とボイン hige to boin,1474,2,0,2,0,1,Nine States
recon elite,1474,2,0,2,0,1,Combo Breaker
fv sangbubu,1474,2,0,2,0,1,FV Cup
spenttime,1474,2,0,2,0,1,Northwest Majors
guitar7s,1474,2,0,2,0,1,CEO
c88_tbn daymein,1474,2,0,2,0,1,Texas Showdown
set,1474,2,0,2,0,1,CEO
babycakes,1474,2,0,2,0,1,CEO
setx|[kf] @iwasblocking,1474,2,0,2,0,1,Texas Showdown
豆奶,1474,2,0,2,0,1,Ze Fighting Game Champion
大俠趕羚羊,1474,2,0,2,0,1,Taiwan
arkanis,1474,2,0,2,0,1,Texas Showdown
moddren-l fuego,1474,2,0,2,0,1,Texas Showdown
moist,1474,2,0,2,0,1,Northwest Majors
papa giasso,1474,2,0,2,0,1,TFC
屠村客,1474,2,0,2,0,1,Taiwan
terry kok,1474,2,0,2,0,1,FV Cup
tomjw88,1474,2,0,2,0,1,CEO
christian,1474,2,0,2,0,1,Ze Fighting Game Champion
'daitarn 3,1474,2,0,2,0,1,CEO
沈鹏 triple-k,1474,2,0,2,0,1,CPTA Shanghai
mrxrubin,1474,2,0,2,0,1,Northwest Majors
py,1474,2,0,2,0,1,Ze Fighting Game Champion
ucc|mattikus,1474,2,0,2,0,1,Texas Showdown
765pro,1474,2,0,2,0,1,Northwest Majors
[kf] mdrm,1474,2,0,2,0,1,Texas Showdown
汪俊峰 fei-long,1474,2,0,2,0,1,CPTA Shanghai
mehdi,1474,2,0,2,0,1,Ze Fighting Game Champion
yopumpkinhead,1474,2,0,2,0,1,Northwest Majors
紫月,1474,2,0,2,0,1,Ze Fighting Game Champion
30f|teyah,1474,2,0,2,0,1,Northwest Majors
exg convictedoffun,1474,2,0,2,0,1,CEO
ua|mrhoward123,1474,2,0,2,0,1,Texas Showdown
asnakeasolid,1474,2,0,2,0,1,CEO
renzuo,1474,2,0,2,0,1,FV Cup
u_no_hoo,1474,2,0,2,0,1,CEO
kevin munoz,1474,2,0,2,0,1,TFC
anbu arisato,1474,2,0,2,0,1,CEO
tuan,1474,2,0,2,0,1,Northwest Majors
indmou,1474,2,0,2,0,1,Ze Fighting Game Champion
cxhwang,1474,2,0,2,0,1,Northwest Majors
souler,1474,2,0,2,0,1,Ze Fighting Game Champion
dkn29,1474,2,0,2,0,1,Northwest Majors
阿豪,1474,2,0,2,0,1,Taiwan
rain,1474,2,0,2,0,1,Northwest Majors
japhk,1474,2,0,2,0,1,HK
anotheryou,1474,2,0,2,0,1,FV Cup
fatdog,1474,2,0,2,0,1,Ze Fighting Game Champion
mclovin,1474,2,0,2,0,1,TFC
mardon,1474,2,0,2,0,1,Combo Breaker
r.mitake,1474,2,0,2,0,1,Nine States
これ!どれ?アレ!ん kore!dore? are! n,1474,2,0,2,0,1,Nine States
calmspaghetti,1474,2,0,2,0,1,NorCal Regionals
simplyktg,1474,2,0,2,0,1,CEO
dikdik,1474,2,0,2,0,1,FV Cup
beamsprouts,1474,2,0,2,0,1,NorCal Regionals
geronimo,1474,2,0,2,0,1,SCR
jesse munoz,1474,2,0,2,0,1,TFC
ok-gandy,1474,2,0,2,0,1,CEO
graystump,1474,2,0,2,0,1,NorCal Regionals
chibz,1474,2,0,2,0,1,NorCal Regionals
rocksteady,1474,2,0,2,0,1,SCR
ken yeung kenyeung,1474,2,0,2,0,1,HK
jesse hamilton,1474,2,0,2,0,1,TFC
hui chun hin xft-musicwizard,1474,2,0,2,0,1,HK
geenoh,1474,2,0,2,0,1,SCR
ex,1474,6,2,4,33,2,NorCal Regionals;CEO
retro glacius,1474,2,0,2,0,1,SCR
aquamandog,1474,2,0,2,0,1,Combo Breaker
legendarygamer,1474,2,0,2,0,1,SCR
tom b,1474,2,0,2,0,1,VS Fighting
afaliq bin yusof afaliq90,1474,2,0,2,0,1,CPTA Shanghai
el-psy,1474,2,0,2,0,1,CEO
baker,1474,2,0,2,0,1,SCR
l4,1474,2,0,2,0,1,TFC
smbf|oxidopamine,1474,2,0,2,0,1,VS Fighting
kylexxpro,1474,2,0,2,0,1,VS Fighting
empr.pxg daytonj,1474,2,0,2,0,1,Combo Breaker
チキチキン,1474,2,0,2,0,1,Nine States
señor goggles,1474,2,0,2,0,1,SCR
teaseeoh,1474,2,0,2,0,1,CEO
barrazie,1474,2,0,2,0,1,NorCal Regionals
shige,1474,2,0,2,0,1,CPTA Last Chance Qualifier
chase,1474,2,0,2,0,1,SCR
src grayson,1474,2,0,2,0,1,Combo Breaker
reuben,1474,2,0,2,0,1,VS Fighting
zds,1474,2,0,2,0,1,Combo Breaker
eliver ling,1474,2,0,2,0,1,NorCal Regionals
stepmasterryan,1474,2,0,2,0,1,SCR
j.baysik,1474,2,0,2,0,1,NorCal Regionals
choobacca,1474,2,0,2,0,1,CPTA Last Chance Qualifier
professor beef,1474,2,0,2,0,1,NorCal Regionals
gary artairias,1474,2,0,2,0,1,HK
ds|rythla,1474,2,0,2,0,1,VS Fighting
iebg dreammerchant,1474,2,0,2,0,1,SCR
kaptain,1474,2,0,2,0,1,VS Fighting
setx|hd,1474,2,0,2,0,1,Texas Showdown
reiji,1474,2,0,2,0,1,TFC
squid kid,1474,2,0,2,0,1,CPTA Last Chance Qualifier
tombstone,1474,2,0,2,0,1,TFC
ph emberandroses,1474,2,0,2,0,1,SCR
lorichumley05 15,1474,2,0,2,0,1,CPTA Shanghai
shindoru,1474,2,0,2,0,1,VS Fighting
bcw big tone,1474,2,0,2,0,1,CEO
lee chun ho lee,1474,2,0,2,0,1,HK
nb elithecurry,1474,2,0,2,0,1,CEO
shing07,1474,2,0,2,0,1,NorCal Regionals
キッド,1474,2,0,2,0,1,Nine States
wrongonred,1474,2,0,2,0,1,CEO
nz|notinal,1474,2,0,2,0,1,NorCal Regionals
gnixer,1474,2,0,2,0,1,CPTA Last Chance Qualifier
biscuitpinoy,1474,2,0,2,0,1,NorCal Regionals
idiocy,1474,2,0,2,0,1,NorCal Regionals
doons,1474,2,0,2,0,1,NorCal Regionals
pinecone,1474,2,0,2,0,1,SCR
いす市長,1474,2,0,2,0,1,Nine States
vgd,1474,2,0,2,0,1,CPTA Last Chance Qualifier
marquezsf,1474,2,0,2,0,1,NorCal Regionals
terrymc,1474,2,0,2,0,1,Combo Breaker
jt,1474,2,0,2,0,1,NorCal Regionals
dwe|mcbae,1474,2,0,2,0,1,TFC
pmoney,1474,2,0,2,0,1,SCR
phantom miria,1474,2,0,2,0,1,NorCal Regionals
auto au auto,1474,2,0,2,0,1,HK
ramjam,1474,2,0,2,0,1,Combo Breaker
bfl|mr stabbie,1474,2,0,2,0,1,VS Fighting
rst sinful,1474,2,0,2,0,1,CEO
954_doza,1474,2,0,2,0,1,CEO
ed|neodurge,1474,2,0,2,0,1,VS Fighting
j king tha 1st,1474,2,0,2,0,1,Combo Breaker
meatyfp,1474,2,0,2,0,1,CEO
virus,1474,2,0,2,0,1,NorCal Regionals
+dq+,1474,2,0,2,0,1,HK
mr.e,1474,2,0,2,0,1,VS Fighting
ovo demonhead,1474,2,0,2,0,1,SCR
jesse fong,1474,2,0,2,0,1,SCR
rhinostarr,1474,2,0,2,0,1,VS Fighting
mochalatteee,1474,2,0,2,0,1,SCR
noctis_786,1474,2,0,2,0,1,VS Fighting
hertzshmertz,1474,2,0,2,0,1,SCR
ryer,1474,2,0,2,0,1,CEO
missingno.,1474,2,0,2,0,1,SCR
irep shadz,1474,2,0,2,0,1,VS Fighting
setx spurs21,1474,2,0,2,0,1,Texas Showdown
rapidblade05,1474,2,0,2,0,1,Combo Breaker
beast mode,1474,2,0,2,0,1,Texas Showdown
fuzz lightyear,1474,2,0,2,0,1,NorCal Regionals
tsp|timtastic,1474,2,0,2,0,1,NorCal Regionals
nastynizzzle1,1474,2,0,2,0,1,NorCal Regionals
blanco negro,1474,2,0,2,0,1,First Attack
bbs own black_dynowright,1474,2,0,2,0,1,NorCal Regionals
c. chavez,1474,2,0,2,0,1,SCR
ds|pak_mei,1474,2,0,2,0,1,VS Fighting
anbu bpoilspill,1474,2,0,2,0,1,TFC
honestabe,1474,2,0,2,0,1,SCR
setx|tyler (yo.),1474,2,0,2,0,1,Texas Showdown
ed|big man baird,1474,2,0,2,0,1,VS Fighting
bloodmasterlink,1474,2,0,2,0,1,CEO
ssrcg|van slab,1474,2,0,2,0,1,VS Fighting
max'd out,1474,2,0,2,0,1,TFC
sbk,1474,2,0,2,0,1,CPTA Last Chance Qualifier
alfredoedwards 25 alfredoedwards,1474,2,0,2,0,1,HK
clipstream casshern,1474,2,0,2,0,1,CEO
ken-kots,1474,2,0,2,0,1,CEO
joe chau jeono,1474,2,0,2,0,1,HK
shaggy,1474,2,0,2,0,1,VS Fighting
flex negative,1474,2,0,2,0,1,TFC
locojoe,1474,6,2,4,33,2,Combo Breaker;CEO
drago_drk,1474,2,0,2,0,1,NorCal Regionals
andrew gib,1474,2,0,2,0,1,NorCal Regionals
v12 hypnos,1474,2,0,2,0,1,NorCal Regionals
og killatofu,1474,2,0,2,0,1,SCR
og bunch,1474,2,0,2,0,1,CEO
sanchez,1474,2,0,2,0,1,SCR
doscubanos,1474,2,0,2,0,1,CEO
highlevelnovice,1474,2,0,2,0,1,TFC
zee rinkato,1474,2,0,2,0,1,CEO
insertbrainhere,1474,2,0,2,0,1,VS Fighting
dpgl menard,1474,2,0,2,0,1,First Attack
bluesy,1474,2,0,2,0,1,SCR
dmf,1474,2,0,2,0,1,NorCal Regionals
dm|mayho,1474,2,0,2,0,1,SCR
hibiki,1474,2,0,2,0,1,Texas Showdown
pim118,1474,2,0,2,0,1,NorCal Regionals
fadcant pr,1474,2,0,2,0,1,First Attack
jayson,1474,2,0,2,0,1,CPTA Last Chance Qualifier
kjb the hero,1474,2,0,2,0,1,Combo Breaker
gobant,1474,2,0,2,0,1,CEO
thurrabred,1474,2,0,2,0,1,VS Fighting
noggy,1474,2,0,2,0,1,CEO
yy 管家仔,1474,2,0,2,0,1,HK
arcadedreams,1474,2,0,2,0,1,NorCal Regionals
cult of sirlin,1474,2,0,2,0,1,NorCal Regionals
dtflipper,1474,2,0,2,0,1,NorCal Regionals
goukki,1474,2,0,2,0,1,VS Fighting
sroasha,1474,2,0,2,0,1,CEO
gorillapino,1474,2,0,2,0,1,NorCal Regionals
sjbm,1474,2,0,2,0,1,Combo Breaker
hf|tierney,1474,2,0,2,0,1,NorCal Regionals
tiger zebra,1474,2,0,2,0,1,VS Fighting
ramonachan,1474,2,0,2,0,1,First Attack
deanthrax,1474,2,0,2,0,1,CEO
dmc macc,1474,2,0,2,0,1,Combo Breaker
owen tu,1474,2,0,2,0,1,Combo Breaker
昼下がりの団地妻,1474,2,0,2,0,1,Nine States
duke,1474,2,0,2,0,1,VS Fighting
kim il songbo,1474,2,0,2,0,1,CPTA Last Chance Qualifier
toneloki,1474,2,0,2,0,1,NorCal Regionals
ashu j,1474,2,0,2,0,1,CEO
laziepokekai,1474,2,0,2,0,1,NorCal Regionals
hf|dreiss,1474,2,0,2,0,1,NorCal Regionals
sean9217,1474,2,0,2,0,1,VS Fighting
mamobelty,1474,2,0,2,0,1,First Attack
lostperfection,1474,2,0,2,0,1,CEO
naryx,1474,2,0,2,0,1,Combo Breaker
scaryeyes,1474,2,0,2,0,1,Combo Breaker
dux_ryu,1474,2,0,2,0,1,NorCal Regionals
frodo,1474,2,0,2,0,1,Combo Breaker
notbab hadoukant,1474,2,0,2,0,1,Combo Breaker
eddydangerous,1474,2,0,2,0,1,NorCal Regionals
brandon,1474,2,0,2,0,1,Nine States
megaphonejones66,1474,2,0,2,0,1,VS Fighting
chris len,1474,2,0,2,0,1,VS Fighting
majesticstylez,1474,2,0,2,0,1,NorCal Regionals
ke3m07,1474,2,0,2,0,1,CPTA Last Chance Qualifier
aurorakillian 13 aurorakillian,1474,2,0,2,0,1,HK
dex masters,1474,2,0,2,0,1,Combo Breaker
张文亮 happyport,1474,2,0,2,0,1,CPTA Shanghai
dr sharpy,1474,2,0,2,0,1,First Attack
sfo|savant,1474,2,0,2,0,1,VS Fighting
moonrider,1474,2,0,2,0,1,CPTA Last Chance Qualifier
doctor vicious,1474,2,0,2,0,1,CEO
lucius,1474,2,0,2,0,1,CEO
大力 3 3之神大力,1474,2,0,2,0,1,CPTA Shanghai
court,1474,2,0,2,0,1,CEO
やまやん,1474,2,0,2,0,1,Nine States
solidsnaker3d,1474,2,0,2,0,1,CEO
dath,1474,2,0,2,0,1,Ultra Hyakkishu Cup
harpzx007,1474,2,0,2,0,1,VS Fighting
legend of negro,1474,2,0,2,0,1,VS Fighting
rst|ryrie,1474,2,0,2,0,1,Hypespotting
one2remember80,1474,2,0,2,0,1,VS Fighting
rokotsu,1474,2,0,2,0,1,Ultra Hyakkishu Cup
park jkkk hydebuffy,1474,2,0,2,0,1,HK
dr hype,1474,2,0,2,0,1,Hypespotting
鲁俊 水表,1474,2,0,2,0,1,CPTA Shanghai
cheese,1474,2,0,2,0,1,VS Fighting
vs hustle crowe,1474,2,0,2,0,1,Hypespotting
nigiri bison,1474,2,0,2,0,1,Ultra Hyakkishu Cup
teachable,1474,2,0,2,0,1,CEO
1p,1474,2,0,2,0,1,Ultra Hyakkishu Cup
b&b venison,1474,2,0,2,0,1,Combo Breaker
archangel,1474,2,0,2,0,1,VS Fighting
pmcc,1474,2,0,2,0,1,VS Fighting
ornstein,1474,2,0,2,0,1,Hypespotting
justincredible47,1474,2,0,2,0,1,CEO
jacopdr,1474,2,0,2,0,1,KO Fighting Game Festival
lee siu kwan dbj_john,1474,2,0,2,0,1,HK
chilli_palmer,1474,2,0,2,0,1,CEO
eb mars312xd,1474,2,0,2,0,1,Combo Breaker
shunshun,1474,2,0,2,0,1,Ultra Hyakkishu Cup
pootytangfl,1474,2,0,2,0,1,CEO
rst|ruffdawg,1474,2,0,2,0,1,Hypespotting
underage,1474,2,0,2,0,1,Hypespotting
1260-tan,1474,2,0,2,0,1,Ultra Hyakkishu Cup
mmg|spuck,1474,2,0,2,0,1,Hypespotting
tissuemon,1474,2,0,2,0,1,Milan Games Week
legendary mako,1474,2,0,2,0,1,First Attack
施晓波 820821,1474,2,0,2,0,1,CPTA Shanghai
mr. gu,1474,2,0,2,0,1,Combo Breaker
justin chu darkras,1474,2,0,2,0,1,CPTA Shanghai
gr redbaron,1474,2,0,2,0,1,Combo Breaker
onemorething,1474,2,0,2,0,1,Hypespotting
zombie brian,1474,2,0,2,0,1,Hypespotting
midas,1474,2,0,2,0,1,Milan Games Week
olivo,1474,2,0,2,0,1,First Attack
paul ho,1474,2,0,2,0,1,CPTA Last Chance Qualifier
tony tyrant,1474,2,0,2,0,1,HK
squibb,1474,2,0,2,0,1,Milan Games Week
havecontrollerwilltravel,1474,2,0,2,0,1,Combo Breaker
eligtkderic,1474,2,0,2,0,1,CEO
opienus,1474,2,0,2,0,1,CEO
marcorydah,1474,2,0,2,0,1,Milan Games Week
lcx lcx1988,1474,2,0,2,0,1,CPTA Shanghai
gp romora,1474,2,0,2,0,1,CEO
hosea fidel,1474,2,0,2,0,1,Hypespotting
ig|bole,1474,2,0,2,0,1,First Attack
angry black,1474,2,0,2,0,1,Combo Breaker
kaiweiwong homer0708,1474,2,0,2,0,1,HK
eyoh_ajax,1474,2,0,2,0,1,Combo Breaker
colonel suave,1474,2,0,2,0,1,First Attack
sonimatic14,1474,2,0,2,0,1,CEO
tyson,1474,2,0,2,0,1,CPTA Shanghai
alex yang,1474,2,0,2,0,1,CPTA Last Chance Qualifier
hom philocypher,1474,2,0,2,0,1,Combo Breaker
alteredturbomax,1474,2,0,2,0,1,Milan Games Week
julian13,1474,2,0,2,0,1,Combo Breaker
mateo fratus,1474,2,0,2,0,1,Milan Games Week
范伦豪 mars,1474,2,0,2,0,1,CPTA Shanghai
dtjb,1474,2,0,2,0,1,Combo Breaker
terra,1474,2,0,2,0,1,Hypespotting
deathtattoo83,1474,2,0,2,0,1,Combo Breaker
insidious vince,1474,2,0,2,0,1,CEO
xiaowei xia mohai,1474,2,0,2,0,1,CPTA Shanghai
master sarayut,1474,2,0,2,0,1,Milan Games Week
fgerizu,1474,2,0,2,0,1,First Attack
joel hosty05,1474,2,0,2,0,1,CPTA Shanghai
罗国樑 robert仔,1474,2,0,2,0,1,HK
kush95,1474,2,0,2,0,1,Milan Games Week
marzipan,1474,2,0,2,0,1,Hypespotting
crash,1474,2,0,2,0,1,Milan Games Week
steve,1474,2,0,2,0,1,Hypespotting
pand089,1474,2,0,2,0,1,Milan Games Week
nutri96,1474,2,0,2,0,1,Milan Games Week
kyorikusagami,1474,2,0,2,0,1,CEO
exp scythe,1474,2,0,2,0,1,Combo Breaker
flupty,1474,2,0,2,0,1,Hypespotting
the last hairbender,1474,2,0,2,0,1,Combo Breaker
maes alexis hittheplane,1474,2,0,2,0,1,HK
めりっぷ,1474,6,2,4,33,1,Nine States
thores,1474,2,0,2,0,1,Combo Breaker
silverhydra,1474,2,0,2,0,1,Combo Breaker
gr danimal,1474,2,0,2,0,1,Combo Breaker
od|dbiohazard,1474,2,0,2,0,1,First Attack
ansatsusha,1474,2,0,2,0,1,Hypespotting
laoghe,1474,2,0,2,0,1,Milan Games Week
lsteveboxl,1474,2,0,2,0,1,Hypespotting
lee ka ho ys,1474,2,0,2,0,1,HK
hugo-andore,1474,2,0,2,0,1,First Attack
kiandres,1474,2,0,2,0,1,Milan Games Week
snoopylooker,1474,2,0,2,0,1,Hypespotting
b&b mm_food,1474,2,0,2,0,1,Combo Breaker
supermrjmt,1474,2,0,2,0,1,Combo Breaker
aof e-dawg,1474,2,0,2,0,1,CEO
drewmorri7,1474,2,0,2,0,1,Hypespotting
yong zhu ddj|yong,1474,2,0,2,0,1,CPTA Shanghai
tuyetmiles9 22,1474,2,0,2,0,1,CPTA Shanghai
ah xi,1474,2,0,2,0,1,CPTA Shanghai
ed|hawxx is rippin,1474,2,0,2,0,1,Hypespotting
phantom,1474,2,0,2,0,1,CEO
gohancachat,1474,2,0,2,0,1,CEO
冯云龙 elaialong,1474,2,0,2,0,1,CPTA Shanghai
premiumtax,1474,2,0,2,0,1,CEO
rudetuna,1474,2,0,2,0,1,Combo Breaker
drm steikachay,1474,2,0,2,0,1,Hypespotting
gh dsc thenyion,1474,2,0,2,0,1,CEO
berzack,1474,2,0,2,0,1,True Challengers Costa Rica
tss atma,1474,2,0,2,0,1,Hypespotting
shirkerbee,1474,2,0,2,0,1,Hypespotting
noahspencer84 19,1474,2,0,2,0,1,CPTA Shanghai
derek magee,1474,2,0,2,0,1,SCR
superiorshadow,1473,2,0,2,0,1,CEO
biscuit,1473,2,0,2,0,1,Northwest Majors
rsd beef,1473,2,0,2,0,1,Red Fight District
f99|driftwood,1473,5,1,4,20,3,Final Round;EVO;SCR
smbf|vertigo,1473,2,0,2,0,1,VS Fighting
mba|sono,1473,6,2,4,33,2,Hypespotting;VS Fighting
krono,1473,2,0,2,0,1,Combo Breaker
billy mcgee,1473,2,0,2,0,1,Combo Breaker
beppe yagami79,1473,2,0,2,0,1,Milan Games Week
ua|m.betty,1473,4,1,3,25,1,Texas Showdown
dj storm,1473,2,0,2,0,1,CPTA Last Chance Qualifier
marco mazzanti,1473,2,0,2,0,1,Milan Games Week
star,1473,2,0,2,0,1,VS Fighting
hon yu sum troublemaker,1473,2,0,2,0,1,HK
man filth,1473,2,0,2,0,1,Red Fight District
tekkon,1473,2,0,2,0,1,VS Fighting
deibu,1473,2,0,2,0,1,VS Fighting
jkkk,1473,2,0,2,0,1,CPTA KR
volkmair,1473,2,0,2,0,1,VS Fighting
mba|the bp tank,1473,6,2,4,33,2,Hypespotting;VS Fighting
chima,1473,2,0,2,0,1,Combo Breaker
captain steel,1473,2,0,2,0,1,VS Fighting
jwoods,1473,2,0,2,0,1,VS Fighting
dark mavid,1472,2,0,2,0,1,TFC
dreadleif,1472,7,2,5,28,1,Dreamhack Summer
pedro unchained,1472,7,2,5,28,1,Dreamhack Summer
jay,1472,10,4,6,40,3,CEO;Taiwan;Ultra Hyakkishu Cup
iahadima,1471,5,1,4,20,1,Dreamhack Summer
floe,1470,3,0,3,0,2,NorCal Regionals;EVO
agi.rsd.charmingrogue,1470,5,1,4,20,1,Dreamhack Summer
remes,1470,10,3,7,30,1,Dreamhack Summer
shonuff122,1467,5,1,4,20,2,CEO;TFC
flapjacket,1467,3,0,3,0,1,NorCal Regionals
shinobee,1467,8,2,6,25,3,NorCal Regionals;CPTA KR;SCR
dr. cat,1467,5,1,4,20,1,Dreamhack Summer
shivryuken,1466,5,1,4,20,2,Hypespotting;EGX
d.veritas,1466,5,1,4,20,2,CEO;TFC
tm robofobe,1466,10,3,7,30,2,Dreamhack Summer;Dreamhack Winter
潘权迪 xiaoye,1465,5,1,4,20,2,CPTA Shanghai;HK
cg projo,1465,5,1,4,20,2,Combo Breaker;CEO
agilo,1465,8,2,6,25,2,Dreamhack Summer;Red Fight District
itz mark kin4,1464,3,0,3,0,1,Texas Showdown
クンスト,1464,5,1,4,20,2,Nine States;KSB 2015
yuki,1464,5,1,4,20,2,CEO;Saigon Cup
warbio,1464,17,6,11,35,3,Dreamhack Summer;Red Fight District;Dreamhack Winter
pewpewu,1463,5,1,4,20,2,NorCal Regionals;Northwest Majors
seventh trumpet,1463,5,1,4,20,2,NorCal Regionals;Northwest Majors
bass ns,1463,5,1,4,20,2,Texas Showdown;Combo Breaker
ghodere,1463,5,1,4,20,2,NorCal Regionals;SCR
prowners,1463,4,0,4,0,1,Dreamhack Winter
vdon,1463,5,1,4,20,2,NorCal Regionals;Northwest Majors
rst|launchpad mcross,1462,5,1,4,20,2,Hypespotting;VS Fighting
rauce,1462,3,0,3,0,1,Texas Showdown
shin oni,1462,5,1,4,20,2,CEO;First Attack
elicota,1462,3,0,3,0,1,SCR
du ma guile,1462,3,0,3,0,1,SCR
kdit|ren,1461,7,2,5,28,3,Texas Showdown;EVO;EGX
0ctopus0nfire,1460,4,0,4,0,2,CEO;Summer Jam
doxus,1460,12,4,8,33,2,Dreamhack Summer;Dreamhack Winter
thwisteh,1460,4,0,4,0,1,Dreamhack Winter
maven,1459,4,0,4,0,1,Dreamhack Winter
196|patrik,1459,4,0,4,0,1,Dreamhack Winter
spabobin,1457,19,7,12,36,5,Nine States;CPTA KR;KSB 2015;TFC;SCR
张琦 xiyiji,1457,4,0,4,0,1,CPTA Shanghai
hyde,1457,4,0,4,0,2,Nine States;Ultra Hyakkishu Cup
ニア,1457,8,2,6,25,1,Nine States
audriolen,1457,4,0,4,0,2,NorCal Regionals;SCR
fgdojo|ninio,1457,4,0,4,0,1,Dreamhack Winter
pd|n4us,1456,8,2,6,25,3,NorCal Regionals;Northwest Majors;SCR
nake,1456,6,1,5,16,1,Dreamhack Summer
maguro,1456,4,0,4,0,1,Dreamhack Winter
kata,1455,4,0,4,0,1,Dreamhack Winter
kavorca,1454,4,0,4,0,1,Dreamhack Winter
opostrophe,1454,4,0,4,0,1,Dreamhack Winter
ronnyrundspark,1454,4,0,4,0,1,Dreamhack Winter
kilmer,1453,4,0,4,0,1,Dreamhack Winter
yip kai cheong barlowlism,1453,4,0,4,0,1,HK
crosshatched,1453,4,0,4,0,1,Dreamhack Winter
readyforpowwow,1452,4,0,4,0,2,Texas Showdown;SCR
gustavo,1451,4,0,4,0,1,Dreamhack Winter
op|kayjay,1451,4,0,4,0,1,Dreamhack Winter
theflyingcheese,1451,4,0,4,0,1,Nine States
ムラヲ,1451,4,0,4,0,1,Nine States
385wdb|beermir,1450,4,0,4,0,2,Northwest Majors;CEO
ifd delusion,1450,4,0,4,0,2,NorCal Regionals;CEO
radirgy,1450,4,0,4,0,1,VS Fighting
ikea_patrik,1449,5,0,5,0,1,Dreamhack Summer
pr0digy_013,1449,5,0,5,0,1,Dreamhack Summer
james deen,1448,9,2,7,22,2,Dreamhack Summer;Dreamhack Winter
qphj,1447,5,0,5,0,1,Dreamhack Winter
archiba,1446,5,0,5,0,1,Dreamhack Summer
paranoiar,1446,5,0,5,0,1,Dreamhack Summer
dragonfangs,1443,5,0,5,0,1,Dreamhack Summer
pylo,1443,5,0,5,0,1,Dreamhack Summer
jeparianen,1441,5,0,5,0,1,Dreamhack Summer
あきやま,1426,6,0,6,0,1,Nine States
